Hh, Hh, Hh, Hh, Mm, Hh, Hh, Hh, Hh, Gg, Mm, Mm, Mm, Mm, Mm, Mm, Mm, Mm, Mm, Mm, Mm, Gll^Fp, Gll^Fp, Mm, Mm, Mm, Hh, Mm, Mm, Mm, Hh, Mm, Mm, Gg, Mm, Mm, Mm, Mm, Mm, Mm, Mm, Mm, Mm, Mm
Hh, Hh, Mm, Mm, Mm, Mm, Mm, Mm, Mm, Mm, Mm, Mm, Hh, Mm, Mm, Mm, Hh, Mm, Mm, Mm, Mm, Gll^Fp, Gll^Fp, Gll^Fp, Gll^Fp, Mm, Mm, Uu^Vud, Hh, Gs^Fds, Mm, Hh, Hh, Mm, Uu^Vud, Mm, Hh, Uu^Vud, Mm, Mm, Uu^Vud, Hh, Hh, Mm
Hh, Mm, Mm, Ce, Ce, Ce, Ce, Mm, Gg, Mm, Mm, Mm, Mm, Hh, Hh, Mm, Hh, Hh, Hh, Hh, Mm, Mm, Gll^Fp, Gll^Fp, Gll^Fp, Gll^Fp, Mm, Mm, Hh, Mm, Hh, Hh, Mm, Hh, Mm, Hh, Mm, Hh, Hh, Hh, Hh, Mm, Hh, Mm
Hh, Mm, Mm, Ce, 1 Ke, Ce, Ce, Gg, Gg, Gg, Gs^Vh, Gg^Efm, Gg^Efm, Mm, Mm, Hh, Mm, Hh, Mm, Hh, Mm, Mm, Gll^Fp, Gll^Fp, Gs^Fms, Gll^Fp, Gll^Fp, Mm, Mm, Uu^Vud, Hh, Mm, Mm, Mm, Cf, Cf, Cf, Mm, Mm, Mm, Gll^Fp, Mm, Hh, Mm
Mm, Hh, Mm, Ce, Ce, Ce, Ce, Gg, Gg, Rb, Rb, Gg, Rb, Mm, Gs^Fds, Mm, Mm, Mm, Mm, Mm, Gll^Fp, Gs^Fds, Gg^Fet, Gll^Fp, Gll^Fp, Gll^Fp, Gll^Fp, Mm, Mm, Hh, Hh, Mm, Mm, Cf, Cf, 2 Kf, Cf, Mm, Mm, Mm, Mm, Mm, Hh, Mm
Mm, Hh, Hh, Mm, Mm, Ce, Gg, Gg, Rb, Gll^Fp, Gll^Fp, Rb, Gll^Fp, Gs^Fds, Gs^Fds, Gg^Ve, Gs^Fds, Gg^Es, Gg^Es, Gg^Es, Gg, Gll^Fp, Gll^Fp, Gll^Fp, Gll^Fp, Gs^Fds, Gll^Fp, Mm, Mm, Hh, Uu^Vud, Hh, Hh, Mm, Mm, Cf, Mm, Mm, Hh, Mm, Mm, Hh, Uu^Vud, Mm
Rrc, Mm, Mm, Mm, Mm, Gg, Gg^Efm, Gg, Rb, Gll^Fp, Rb, Gll^Fp, Gs^Fds, Gs^Fds, Gs^Fds, Gs^Fds, Gs^Fds, Gs^Fds, Gs, Gg, Rb, Rb, Rb, Gll^Fp, Gs^Fds, Gll^Fp, Gll^Fp, Gll^Fp, Gll^Fp, Mm, Mm, Mm, Mm, Hh, Hh, Hh, Hh, Hh, Uu^Vud, Hh, Mm, Mm, Mm, Mm
Rb, Rrc, Rrc, Mm, Gs^Vh, Gg^Efm, Gg^Efm, Gg, Gg, Rb, Gg, Rb, Rb, Gll^Fp, Gg, Gll^Fp, Gll^Fp, Gs^Fds, Gs^Fds, Gs, Gs, Gs^Fds, Gs^Fds, Gs^Fds, Gs^Fds, Gll^Fp, Gs^Fds, Gs^Fds, Gg, Gg, Gg, Mm, Mm, Mm, Mm, Mm, Mm, Mm, Mm, Mm, Mm, Mm, Mm, Mm
Ww, Rb, Rb, Rrc, Rrc, Rrc, Rrc, Rrc, Rrc, Rrc, Rrc, Gg, Rrc, Gg, Rrc, Gg, Rrc, Gll^Fp, Rrc, Gg, Gg, Gll^Fp, Gg, Gs^Fds, Gg, Gll^Fp, Gg, Gs^Fds, Gg, Gg, Gg, Gg, Gg, Gg, Gg, Gg, Rrc, Rrc, Gll^Fp, Gg^Fet, Gll^Fp, Mm, Gll^Fp, Gg
Ww, Rb, Gg, Gg, Gg, Gg^Efm, Gg^Efm, Gg^Efm, Gg^Efm, Rrc, Gg, Rrc, Rb, Rrc, Gg, Rrc, Gg, Rrc, Rrc, Rrc, Rrc, Gg, Gg, Gg, Gg^Efm, Gg^Efm, Gg^Efm, Gg, Gg, Gg, Gg, Gg, Rrc, Rrc, Rrc, Gg, Rrc, Gg, Gg^Efm, Gll^Fp, Gg^Es, Gll^Fp, Gg^Es, Gg
Hh, Rb, Hh, Gg, Ww, Gg, Ww, Ww, Ww, Gg^Efm, Rb^Efm, Gg, Gg, Gg, Gg^Efm, Gg, Gg^Efm, Gg, Gg^Efm, Rb, Gg, Rrc, Rrc, Gg^Efm, Rrc, Gg^Efm, Rrc, Rrc, Rrc, Rrc, Rrc, Rrc, Gg, Gg, Gg, Rrc, Rrc, Gg^Efm, Gg, Gg^Efm, Gg^Efm, Gg^Es, Gg^Es, Gg^Es
Hh, Hh, Hh, Hh, Hh, Ww, Gll^Fp, Ww, Gll^Fp, Rb, Rb, Gg, Gll^Fp, Gll^Fp, Gll^Fp, Gll^Efm, Gll^Fp, Gg^Efm, Gg^Efm, Gg^Efm, Gg^Efm, Gg, Gll^Fp, Rrc, Gll^Fp, Rrc, Gg, Gg, Gll^Fp, Gg, Gll^Fp, Gll^Fp, Gll^Fp, Gg^Es, Gg^Es, Rrc, Gg, Rrc, Rrc, Gg, Gg, Gg^Efm, Gg^Efm, Gg^Efm
Hh, Hh, Gll^Fp, Hh, Hh, Hh, Hh, Gll^Fp, Gll^Fp, Gll^Fp, Gll^Fp, Rb, Rb, Gs^Vl, Gll^Fp, Rb, Rb, Gll^Fp, Gll^Fp, Gll^Fp, Gg, Gll^Fp, Gg, Gg, Gg, Gll^Fp, Gll^Fp, Gll^Fp, Rb, Gg, Gg, Gg^Efm, Gll^Fp, Gg, Gg^Es, Rrc, Gg, Gg, Ww, Rrc, Rrc, Gg, Gg, Gg^Efm
Hh, Hh, Gll^Fp, Gll^Fp, Hh, Hh, Rb, Rb, Gll^Fp, Gll^Fp, Gll^Fp, Gll^Fp, Rb, Rb, Rb, Rb, Rb, Rb, Gll^Fp, Gll^Fp, Gg, Gll^Fp, Gll^Fp, Gll^Fp, Gll^Fp, Gll^Fp, Gll^Fp, Rb, Rb, Rb, Rb, Gll^Fp, Gll^Fp, Gg, Gg, Rrc, Gg, Ww, Ww, Ww, Gs^Fds, Rrc, Rrc, Gg
Hh, Hh, Hh, Hh, Hh, Gll^Fp, Gll^Fp, Rb, Rb, Gll^Fp, Gs^Vl, Gll^Fp, Gll^Fp, Rb, Gll^Fp, Rb, Rb, Rb, Ww, Gll^Fp, Rb, Gll^Fp, Gll^Fp, Gll^Fp, Gll^Fp, Gg, Gll^Fp, Gll^Fp, Gll^Fp, Rb, Gll^Fp, Rb, Rb, Gg, Gg^Es, Rrc, Gg, Ww, Gs^Fds, Gs^Fds, Gs^Fds, Gs^Fds, Hh, Rrc
Hh, Hh, Gll^Fp, Hh, Gll^Fp, Hh, Hh, Rb, Rb, Hh, Gg^Es, Gll^Fp, Gg^Efm, Rb, Gg, Gs^Vl, Ww, Ww, Gll^Fp, Gll^Fp, Gg, Rb, Rb, Gg^Es, Gg^Es, Gg, Rb, Gll^Fp, Gll^Fp, Gll^Fp, Gll^Fp, Gll^Fp, Gll^Fp, Rb, Gg^Es, Rrc, Rrc, Ww, Gs^Fds, Rb, Hh, Rb, Hh, Hh
Hh, Hh, Hh, Hh, Hh, Gll^Fp, Hh, Hh, Gll^Fp, Gll^Fp, Gg^Es, Rb, Rb, Gll^Fp, Rb, Gll^Fp, Ww, Ww, Gll^Fp, Gll^Fp, Gg, Gll^Fp, Rb, Rb, Gg, Rb, Rb, Rb, Gll^Fp, Gll^Fp, Ww, Ww, Rb, Rb, Gg^Es, Rrc, Rrc, Gs^Fds, Gs^Fds, Re^Vct, Hh, Hh, Rb, Hh
Hh, Hh, Hh, Hh, Gll^Fp, Gs^Fms, Gll^Fp, Hh, Rb, Gll^Fp, Rb, Gll^Fp, Rb, Rb, Gll^Fp, Gll^Fp, Gg, Rb, Gg, Rb, Gg, Gg, Rb, Gll^Fp, Gll^Fp, Gll^Fp, Gll^Fp, Rb, Rb, Gs^Fds, Gll^Fp, Gll^Fp, Gll^Fp, Rb, Gg, Rrc, Rrc, Rrc, Rb, Gs^Fds, Hh, Hh, Hh, Hh
Hh, Hh, Gll^Fp, Hh, Rb, Gll^Fp, Gll^Fp, Gll^Fp, Gll^Fp, Rb, Ww, Ww, Ww, Rb, Rb, Gll^Fp, Rb, Rb, Gs^Vl, Gll^Fp, Gg, Gll^Fp, Gg, Gll^Fp, Rb, Gll^Fp, Gll^Fp, Gg^Es, Rb, Gs^Fds, Gs^Fds, Gll^Fp, Gll^Fp, Gll^Fp, Gll^Fp, Gg, Gg, Rrc, Rrc, Gs^Fds, Rrc, Hh, Hh, Hh
Hh, Hh, Gll^Fp, Hh, Gs^Fms, Gll^Fp, Gll^Fp, Gs^Fds, Rb, Rb, Rb, Ww, Ww, Rb, Rb, Rb, Ce, Rb, Gg, Gll^Fp, Gll^Fp, Gll^Fp, Gg^Emf, Gg^Emf, Rb, Gg, Gll^Fp, Gs^Vl, Rb, Gll^Fp, Gg^Ve, Gs^Fds, Rb, Rb, Rb, Gll^Fp, Gll^Fp, Gg, Gg^Es, Rrc, Rrc, Rrc, Rrc, Hh
Rb, Hh, Gll^Fp, Gll^Fp, Gll^Fp, Gll^Fp, Gll^Fp, Gll^Fp, Gll^Fp, Rb, Ww, Ww, Rb, Rb, Ce, Ce, Ce, Ce, Rb, Gg, Ww, Gg^Emf, Ww, Gll^Fp, Gg, Rb, Ww, Rb, Gll^Fp, Gll^Fp, Gll^Fp, Gll^Fp, Gll^Fp, Gll^Fp, Gll^Fp, Gll^Fp, Gll^Fp, Gg^Es, Gg, Gg^Es, Gg, Rrc, Rrc, Rrc
Rb, Rb, Gll^Fp, Gg^Fet, Gs^Fds, Gs^Fds, Gg^Efm, Gg^Efm, Rb, Rb, Rb, Rb, Rb, Rb, Ce, Ce, 3 Ket, Rb, Rb, Ww, Ww, Ww, Ww, Rb, Rb, Ww, Ww, Ww, Rb, Gll^Fp, Rb, Gll^Fp, Gs^Vl, Gll^Fp, Gg, Hh, Hh, Gs^Fms, Gll^Fp, Gll^Fp, Gll^Fp, Gg, Hh, Rrc
Rb, Rb, Gll^Fp, Ww^Ewl, Ww^Ewl, Gs^Fds, Gll^Fp, Gll^Fp, Rb, Gs^Vh, Gg, Rb, Rb, Rb, Ce, Ce, Rb, Rb, Rb, Rb, Ww, Ww, Gg^Efm, Rb, Rb, Ww, Ww, Ww, Gll^Fp, Rb, Rb, Rb, Gg^Emf, Gll^Fp, Hh, Hh, Hh, Hh, Hh, Gll^Fp, Gll^Fp, Gll^Fp, Hh, Hh
Rb, Gll^Fp, Gll^Fp, Gll^Fp, Rb, Rb, Rb, Rb, Rb, Rb, Gll^Fp, Gg, Rb, Gg, Gg, Ce, Gg, Rb, Rb, Rb, Gg, Rb, Gg^Efm, Gg^Efm, Gll^Fp, Gll^Fp, Rb, Rb, Gll^Fp, Rb, Gll^Fp, Rb, Rb, Hh, Hh, Gs^Vl, Gll^Fp, Hh, Hh, Hh, Hh, Gll^Fp, Hh, Hh
Rb, Rb, Gg, Gg, Gs^Vh, Gll^Fp, Gg^Fet, Gll^Fp, Rb, Rb, Gll^Fp, Gg, Rb, Gg, Gg, Gg, Gg, Gg^Es, Gg^Efm, Gg^Efm, Gs^Vh, Gg^Efm, Gll^Fp, Gll^Fp, Gg^Fet, Gll^Fp, Gs^Vl, Rb, Rb, Rb, Gll^Fp, Gg^Emf, Rb, Gll^Fp, Hh, Gg^Es, Gll^Fp, Gg^Fet, Gg^Es, Hh, Hh, Hh, Hh, Hh
Rb, Rb, Rb, Gg^Fet, Gg^Es, Gg^Es, Rb, Rb, Rb, Gs^Vh, Gg, Gll^Fp, Rb, Gll^Fp, Gll^Fp, Gll^Fp, Gg, Gll^Fp, Gg, Gg, Gg, Gg, Gll^Fp, Gll^Fp, Gg, Gll^Fp, Gll^Fp, Rb, Gll^Fp, Gll^Fp, Gll^Fp, Gll^Fp, Gll^Fp, Gll^Fp, Hh, Gg^Es, Gll^Fp, Hh, Hh, Gll^Fp, Hh, Gs^Emf, Hh, Hh
Gll^Fp, Rb, Gll^Fp, Gll^Fp, Gll^Fp, Rb, Gll^Fp, Gll^Fp, Gg, Rb, Gg, Gg, Gg, Rb, Gg, Gll^Fp, Gg, Gs^Vh, Gg, Gll^Fp, Gll^Fp, Gg, Gll^Fp, Gg, Gg, Gll^Fp, Gg, Gll^Fp, Rb, Gg, Gs^Fds, Gll^Fp, Gg^Ve, Gll^Fp, Gll^Fp, Hh, Hh, Gll^Fp, Hh, Hh, Hh, Hh, Hh, Hh
Gll^Fp, Gll^Fp, Gg^Ve, Gll^Fp, Gll^Fp, Gll^Fp, Gll^Fp, Gll^Fp, Gg, Gg, Ce, Ce, Ce, Rb, Gg, Gg^Fet, Rb, Gll^Fp, Gll^Fp, Gll^Fp, Rb, Gll^Fp, Gll^Fp, Gg, Gll^Fp, Gg, Gg^Fet, Rb, Gll^Fp, Gll^Fp, Gll^Fp, Gs^Fds, Gs^Fds, Gs^Fds, Gs^Fds, Gg, Hh, Gs^Vl, Gll^Fp, Gll^Fp, Gll^Fp, Gg^Es, Hh, Hh
Gg, Gll^Fp, Ww, Gll^Fp, Ww, Gll^Fp, Gll^Fp, Rb, Rb, Ce, Ce, Ce, Ce, Ce, Ce, Gg, Gg^Efm, Rb, Rb, Gs^Vl, Gll^Fp, Gll^Fp, Gll^Fp, Gll^Fp, Gg^Emf, Gg, Gg, Rb, Rb, Gll^Fp, Rb, Gll^Fp, Gll^Fp, Gs^Fds, Gll^Fp, Rb, Gg^Fet, Hh, Hh, Hh, Hh, Hh, Hh, Hh
Gll^Fp, Gll^Fp, Gll^Fp, Ww, Gll^Fp, Gll^Fp, Rb, Gs^Vl, Rb, Ce, Ce, Ce, Ce, 4 Ket, Ce, Gg^Efm, Gg^Efm, Gg^Efm, Gll^Fp, Rb, Gll^Fp, Gll^Fp, Gg^Fet, Gll^Fp, Gll^Fp, Gll^Fp, Gll^Fp, Rb, Gll^Fp, Rb, Hh, Gll^Fp, Rb, Gs^Vh, Rb, Rb, Gll^Fp, Gg^Es, Gll^Fp, Hh, Gll^Fp, Ww, Hh, Gll^Fp
Gg, Gll^Fp, Gll^Fp, Gll^Fp, Gll^Fp, Gll^Fp, Gll^Fp, Gll^Fp, Rb, Ce, Ce, Ce, Ce, Ce, Gg, Gg, Ww, Gll^Fp, Gll^Fp, Gll^Fp, Gs^Fds, Gg^Ve, Gll^Fp, Gll^Fp, Gs^Fds, Gll^Fp, Gg, Gs^Fms, Gll^Fp, Hh, Rb, Rb, Rb, Rb, Rb, Gg, Gg^Fet, Gll^Fp, Gs^Fds, Gll^Fp, Gll^Fp, Ww, Gll^Fp, Hh
Gg, Gll^Fp, Gll^Fp, Gll^Fp, Gg^Ve, Gll^Fp, Gll^Fp, Gll^Fp, Gll^Fp, Rb, Rb, Gg, Gg, Gg, Gg, Ww, Gll^Fp, Gll^Fp, Gll^Fp, Gs^Fds, Gg, Gs^Fds, Gs^Fds, Gll^Fp, Gs^Fds, Gll^Fp, Ww, Ww, Gg^Fet, Gg^Emf, Gg^Emf, Rb, Rb, Rb, Rb, Rb, Gll^Fp, Gll^Fp, Gll^Fp, Gs^Fds, Gll^Fp, Gll^Fp, Gll^Fp, Gll^Fp
Gll^Fp, Gll^Fp, Mm, Gg^Fet, Mm, Gll^Fp, Gg^Es, Gll^Fp, Gll^Fp, Gll^Fp, Gll^Fp, Gll^Fp, Gll^Fp, Gll^Fp, Gll^Fp, Ww, Gll^Fp, Gll^Fp, Gll^Fp, Gll^Fp, Gll^Fp, Gll^Fp, Gll^Fp, Gs^Fds, Gll^Fp, Gg, Ww, Ww, Gll^Fp, Gg, Gs^Vh, Gg^Emf, Gg, Rb, Gll^Fp, Gs^Vl, Gll^Fp, Gll^Fp, Gg^Es, Gs^Fds, Gs^Fds, Gs^Fds, Gll^Fp, Gll^Fp
Hh, Mm, Mm, Mm, Mm, Mm, Mm, Gg^Es, Gll^Fp, Gll^Fp, Gll^Fp, Gll^Fp, Gll^Fp, Gll^Fp, Gll^Fp, Gll^Fp, Gll^Fp, Gll^Fp, Gll^Fp, Gs^Vh, Gll^Fp, Gg, Gg^Emf, Gs^Vh, Gll^Fp, Ww, Gll^Fp, Gll^Fp, Gg^Es, Gll^Fp, Gg^Es, Gll^Fp, Gg, Hh, Hh, Hh, Hh, Hh, Hh, Gll^Fp, Gll^Fp, Gs^Fds, Gg^Fet, Gll^Fp
Hh, Mm, Mm, Mm, Mm, Mm, Mm, Mm, Mm, Mm, Hh, Gll^Fp, Gll^Fp, Gll^Fp, Gg^Ve, Gll^Fp, Gll^Fp, Gll^Fp, Gll^Fp, Gll^Fp, Gg^Fet, Gll^Fp, Gll^Fp, Gg^Emf, Hh, Gll^Fp, Hh, Hh, Hh, Gg^Es, Hh, Gll^Fp, Gll^Fp, Gg^Fet, Gll^Fp, Gll^Fp, Hh, Hh, Mm, Hh, Hh, Hh, Hh, Hh
Mm, Hh, Hh, Mm, Hh, Hh, Mm, Hh, Mm, Gll^Fp, Mm, Gll^Fp, Mm, Hh, Hh, Hh, Hh, Gll^Fp, Hh, Gll^Fp, Gll^Fp, Gll^Fp, Mm, Gll^Fp, Hh, Hh, Mm, Hh, Mm, Hh, Mm, Gll^Fp, Gll^Fp, Gll^Fp, Mm, Hh, Gll^Fp, Hh, Mm, Hh, Hh, Hh, Mm, Mm
