Gs^Fds, Gs^Fds, Gs^Fds, Gs^Fds, Gs^Fds, Gs^Fds, Gs^Fds, Gs^Fds, Gs^Fds, Gs^Fds, Gs^Fds, Wwr, Ww, Ww, Ww, Ww, Ww, Ww, Ww, Ww, Wwr, Gs^Fds, Gll^Fp, Gs^Fds, Gs^Fds, Gs^Fds, Gs^Fds
Gs^Fds, Gs^Fds, Gs^Fds, Gs^Fds, Gs^Fds, Gg^Ve, Gs^Fds, Gs^Fds, Gs^Fds, Gs^Fds, Gs^Fds, Wwr, Ww, Ww, Ww, Ww, Ww, Ww, Ww, Ww, Wwr, Gs^Fds, Gg^Ve, Gs^Fds, Gg^Fet, Gs^Fds, Gs^Fds
Gs^Fds, Gs^Fds, Gs^Fds, Gg^Ve, Gs^Fds, Gs^Fds, Gs^Fds, Gg^Fet, Gs^Fds, Gs^Fds, Gs^Fds, Wwr, Ww, Ww, Ww, Ww, Ww, Ww, Ww, Ww, Wwr, Gs^Fds, Gs^Fds, Gs^Fds, Gll^Fp, Gs^Fds, Gs^Fds
Gs^Fds, Gs^Fds, Gs^Fds, Gs^Fds, Gs^Fds, Gs^Fds, Gs^Fds, Gs^Fds, Gg^Ve, Gs^Fds, Gs^Fds, Wwr, Ww, Ww, Ww, Ww, Ww, Ww, Ww, Ww, Wwr, Gs^Fds, Gg^Fet, Gs^Fds, Gs^Fds, Gs^Fds, Gs^Fds
Gs^Fds, Gs^Fds, Gg^Fet, Gs^Fds, Gll^Fp, Gs^Fds, Gs^Fds, Gs^Fds, Gs^Fds, Gs^Fds, Gs^Fds, Wwr, Ww, Ww, Ww, Ww, Ww, Ww, Ww, Ww, Wwr, Gs^Fds, Gs^Fds, Gs^Fds, Gs^Fds, Gg^Ve, Gs^Fds
Gs^Fds, Gs^Fds, Gs^Fds, Gs^Fds, Gs^Fds, Gs^Fds, Gs^Fds, Gll^Fp, Gs^Fds, Gs^Fds, Gs^Fds, Wwr, Ww, Ww, Ww, Ww, Ww, Ww, Ww, Ww, Wwr, Gll^Fp, Gs^Fds, Gs^Fds, Gs^Fds, Gs^Fds, Gs^Fds
Gs^Fds, Gs^Fds, Gg^Ve, Gs^Fds, Gs^Fds, Gs^Fds, Gs^Fds, Gg^Ve, Gs^Fds, Gs^Fds, Gs^Fds, Wwr, Ww, Ww, Ww, Ww, Ww, Ww, Ww, Ww, Wwr, Gs^Fds, Gs^Fds, Gg^Ve, Gll^Fp, Gs^Fds, Gs^Fds
Gs^Fds, Gs^Fds, Gll^Fp, Gs^Fds, Gs^Fds, Gg^Fet, Gs^Fds, Gs^Fds, Gs^Fds, Gs^Fds, Cv, Wwr, Ww, Ww, Ww, Ww, Ww, Ww, Ww, Ww, Cv, Cv, Cv, Gs^Fds, Gs^Fds, Gg^Fet, Gs^Fds
Gs^Fds, Gs^Fds, Gs^Fds, Gs^Fds, Gs^Fds, Gs^Fds, Gs^Fds, Gs^Fds, Cv, Cv, Cv, Cv, Cv, Ww, Ww, Ww, Ww, Ww, Cv, Cv, Cv, Cv, Cv, Cv, Gs^Fds, Gs^Fds, Gs^Fds
Gs^Fds, Gs^Fds, Gs^Fds, Gs^Fds, Gs^Fds, Gs^Fds, Gs^Fds, Cv, Cv, Cv, Cv, Cv, Cv, Cv, Cv, Ww, Ww, Cv, 2 Kv, Cv, Cv, Cv, Cv, Cv, Gs^Fds, Gs^Fds, Gs^Fds
Gs^Fds, Gg^Fet, Gs^Fds, Gs^Fds, Gs^Fds, Gs^Fds, Gs^Fds, Cv, Cv, Kv, Cv, Cv, Cv, Cv, Cv, Ww^Bsb\, Ww^Bsb\, Cv, Cv, Cv, Cv, Cv, Cv, Cv, Gs^Fds, Gg^Ve, Gs^Fds
Gs^Fds, Gg^Ve, Gs^Fds, Gs^Fds, Gg^Fet, Gs^Fds, Gs^Fds, Cv, Cv, Cv, Cv, Cv, Cv, Cv, Cv, Ww, Ww, Cv, Cv, Cv, Cv, Cv, Cv, Cv, Gs^Fds, Gs^Fds, Gs^Fds
Gs^Fds, Gs^Fds, Gs^Fds, Gs^Fds, Gs^Fds, Gs^Fds, Gs^Fds, Cv, Cv, Cv, Cv, Cv, Cv, 3 Kv, Cv, Ww, Ww, Cv, Cv, Cv, Cv, Cv, 4 Kv, Cv, Gs^Fds, Gg^Fet, Gs^Fds
Gs^Fds, Gs^Fds, Gs^Fds, Gll^Fp, Gs^Fds, Gg^Ve, Gs^Fds, Cv, Cv, Cv, Cv, Cv, Cv, Cv, Cv, Ww^Bsb\, Ww^Bsb\, Cv, Cv, Cv, Cv, Cv, Cv, Cv, Gs^Fds, Gs^Fds, Gs^Fds
Gs^Fds, Gs^Fds, Gs^Fds, Gs^Fds, Gs^Fds, Gs^Fds, Gs^Fds, Cv, Cv, Cv, Cv, Cv, Cv, Cv, Cv, Ww, Ww, Cv, Cv, Cv, Cv, Cv, Cv, Cv, Gs^Fds, Gs^Fds, Gs^Fds
Gs^Fds, Gg^Ve, Gs^Fds, Gg^Fet, Gs^Fds, Gs^Fds, Gs^Fds, Cv, Kv, Cv, Cv, Cv, Cv, Cv, Cv, Ww, Ww, Cv, 1 Kv, Cv, Cv, Cv, Cv, Cv, Gs^Fds, Gg^Ve, Gs^Fds
Gs^Fds, Gs^Fds, Gs^Fds, Gs^Fds, Gg^Ve, Gs^Fds, Gs^Fds, Cv, Cv, Cv, Cv, Cv, Cv, Cv, Cv, Ww^Bsb\, Ww^Bsb\, Cv, Cv, Cv, Cv, Cv, Cv, Cv, Gs^Fds, Gs^Fds, Gs^Fds
Gs^Fds, Gs^Fds, Gs^Fds, Gll^Fp, Gs^Fds, Gs^Fds, Gs^Fds, Cv, Cv, Cv, Cv, Cv, Cv, Cv, Cv, Ww, Ww, Cv, Cv, Cv, Cv, Cv, Kv, Cv, Gs^Fds, Gg^Fet, Gll^Fp
Gs^Fds, Gs^Fds, Gll^Fp, Gs^Fds, Gs^Fds, Gs^Fds, Gs^Fds, Cv, Cv, Cv, Cv, Kv, Cv, Cv, Cv, Ww, Ww, Cv, Cv, Cv, Cv, Cv, Cv, Cv, Gs^Fds, Gs^Fds, Gs^Fds
Gs^Fds, Gs^Fds, Gs^Fds, Gs^Fds, Gs^Fds, Gs^Fds, Gs^Fds, Gs^Fds, Gs^Fds, Cv, Cv, Cv, Cv, Cv, Ww, Ww, Ww, Ww, Ww, Cv, Cv, Cv, Gs^Fds, Gs^Fds, Gs^Fds, Gs^Fds, Gs^Fds
Gs^Fds, Gs^Fds, Gs^Fds, Gs^Fds, Gll^Fp, Gs^Fds, Gs^Fds, Gll^Fp, Gs^Fds, Gs^Fds, Gs^Fds, Cv, Ww, Ww, Ww, Ww, Ww, Ww, Ww, Ww, Wwr, Gs^Fds, Gg^Fet, Gs^Fds, Gs^Fds, Gg^Fet, Gs^Fds
Gs^Fds, Gg^Ve, Gs^Fds, Gg^Fet, Gs^Fds, Gs^Fds, Gs^Fds, Gs^Fds, Gs^Fds, Gs^Fds, Gs^Fds, Wwr, Ww, Ww, Ww, Ww, Ww, Ww, Ww, Ww, Wwr, Gs^Fds, Gs^Fds, Gs^Fds, Gg^Ve, Gll^Fp, Gs^Fds
Gs^Fds, Gs^Fds, Gs^Fds, Gs^Fds, Gs^Fds, Gs^Fds, Gg^Fet, Gs^Fds, Gll^Fp, Gs^Fds, Gs^Fds, Wwr, Ww, Ww, Ww, Ww, Ww, Ww, Ww, Ww, Wwr, Gs^Fds, Gs^Fds, Gs^Fds, Gs^Fds, Gs^Fds, Gs^Fds
Gs^Fds, Gs^Fds, Gll^Fp, Gs^Fds, Gs^Fds, Gs^Fds, Gs^Fds, Gg^Ve, Gs^Fds, Gs^Fds, Gs^Fds, Wwr, Ww, Ww, Ww, Ww, Ww, Ww, Ww, Ww, Wwr, Gs^Fds, Gs^Fds, Gll^Fp, Gs^Fds, Gs^Fds, Gs^Fds
Gs^Fds, Gs^Fds, Gs^Fds, Gs^Fds, Gs^Fds, Gs^Fds, Gs^Fds, Gs^Fds, Gll^Fp, Gs^Fds, Gs^Fds, Wwr, Ww, Ww, Ww, Ww, Ww, Ww, Ww, Ww, Wwr, Gg^Fet, Gs^Fds, Gs^Fds, Gs^Fds, Gs^Fds, Gs^Fds
Gs^Fds, Gg^Fet, Gs^Fds, Gg^Ve, Gll^Fp, Gs^Fds, Gg^Fet, Gs^Fds, Gs^Fds, Gs^Fds, Gs^Fds, Wwr, Ww, Ww, Ww, Ww, Ww, Ww, Ww, Ww, Wwr, Gs^Fds, Gg^Ve, Gs^Fds, Gs^Fds, Gg^Ve, Gs^Fds
Gs^Fds, Gll^Fp, Gs^Fds, Gs^Fds, Gs^Fds, Gs^Fds, Gs^Fds, Gll^Fp, Gs^Fds, Gs^Fds, Gs^Fds, Wwr, Ww, Ww, Ww, Ww, Ww, Ww, Ww, Ww, Wwr, Gs^Fds, Gs^Fds, Gll^Fp, Gg^Fet, Gs^Fds, Gs^Fds
Gs^Fds, Gs^Fds, Gs^Fds, Gs^Fds, Gs^Fds, Gs^Fds, Gs^Fds, Gs^Fds, Gs^Fds, Gs^Fds, Gs^Fds, Wwr, Ww, Ww, Ww, Ww, Ww, Ww, Ww, Ww, Wwr, Gs^Fds, Gs^Fds, Gs^Fds, Gs^Fds, Gs^Fds, Gs^Fds
