Gll^Fp, Gg, Gll^Fp, Gll^Fp, Gll^Fp, Gg, Gll^Fp, Gg, Gg, Gll^Fp, Gll^Fp, Gll^Fp, Gg, Gg, Gg, Gg, Gg, Gg, Gs^Fds, Gg, Gll^Fp, Gll^Fp, Gll^Fp, Gg, Gll^Fp, Gg, Gg, Gg, Gll^Fp, Gll^Fp, Gll^Fp, Gg, Gg, Gg, Gg, Gll^Fp, Gll^Fp, Gg, Gll^Fp, Gll^Fp, Gll^Fp, Gg, Gll^Fp, Gg, Gg
Gll^Fp, Gll^Fp, Gll^Fp, Gg, Gll^Fp, Gg, Gll^Fp, Gg, Gll^Fp, Gg, Gll^Fp, Gll^Fp, Gll^Fp, Gg, Gg, Gg, Gll^Fp, Gs^Fds, Gs^Fds, Gs^Fds, Gs^Fds, Gg^Efm, Gg^Efm, Gg^Efm, Gg, Gg, Gg^Fet, Gll^Fp, Gs^Fds, Gs^Fds, Gg, Gll^Fp, Gll^Fp, Gll^Fp, Gg, Gll^Fp, Gg, Gll^Fp, Gg, Gg, Gll^Fp, Gll^Fp, Gg^Ve, Gg, Gll^Fp
Gll^Fp, Gll^Fp, Gll^Fp, Gll^Fp, Ce, Ce, Ce, Gll^Fp, Gg, Gg, Gg^Ve, Gs^Fds, Gs^Fds, Gg^Efm, Gg^Efm, Gg, Gs^Fds, Gs^Fds, Gs^Fds, Gs^Fds, Gs^Fds, Gll^Fp, Gg^Efm, Gg^Efm, Gll^Fp, Gll^Fp, Gll^Fp, Gll^Fp, Gll^Fp, Gs^Fds, Gs^Fds, Gs^Fds, Gll^Fp, Gg^Ve, Gll^Fp, Gll^Fp, Gll^Fp, Gg, Gll^Fp, Gll^Fp, Gll^Fp, Gg, Gll^Fp, Gll^Fp, Gg
Gll^Fp, Gll^Fp, Ce, Ce, Ce, Ce, Ce, Gll^Fp, Gg, Gll^Fp, Gll^Fp, Gs^Fds, Gs^Fds, Gll^Fp, Gg^Efm, Gs^Fds, Gs^Fds, Gs^Fds, Gs^Fds, Gs^Fds, Gll^Fp, Gll^Fp, Gll^Fp, Gll^Fp, Gll^Fp, Gg, Gll^Fp, Gg^Ve, Gg, Gs^Fds, Gs^Fds, Gs^Fds, Gll^Fp, Gll^Fp, Gg, Gll^Fp, Ce, Gll^Fp, Ce, Ce, Ce, Gll^Fp, Gll^Fp, Gg, Gg
Gll^Fp, Ce, Ce, 3 Ke, Ce, Ce, Gll^Fp, Gll^Fp, Gll^Fp, Gll^Fp, Gll^Fp, Gs^Fds, Gs^Fds, Gll^Fp, Gg^Efm, Gg^Efm, Gll^Fp, Gs^Fds, Gs^Fds, Gs^Fds, Gll^Fp, Gll^Fp, Gll^Fp, Gg^Efm, Gg^Ve, Gll^Fp, Gll^Fp, Gll^Fp, Gg, Gll^Fp, Gg^Efm, Gll^Fp, Gll^Fp, Gll^Fp, Gll^Fp, Gg, Gll^Fp, Ce, Ce, 4 Ke, Ce, Ce, Gll^Fp, Gg^Ve, Gg
Gll^Fp, Ce, Gll^Fp, Ce, Gll^Fp, Gll^Fp, Gll^Fp, Gll^Fp, Gll^Fp, Gll^Fp, Gs^Fds, Gs^Fds, Gll^Fp, Gll^Fp, Gll^Fp, Gll^Fp, Gg, Gll^Fp, Gll^Fp, Gll^Fp, Gg^Fet, Gg, Gg^Efm, Gg^Efm, Gg^Efm, Gg^Efm, Gll^Fp, Gg^Efm, Gg^Efm, Gll^Fp, Gll^Fp, Gll^Fp, Gg^Fet, Gg, Gg, Gll^Fp, Ce, Ce, Ce, Ce, Gll^Fp, Ce, Gll^Fp, Gll^Fp, Gll^Fp
Gll^Fp, Gll^Fp, Gll^Fp, Gll^Fp, Gll^Fp, Gll^Fp, Gg^Ve, Gll^Fp, Gll^Fp, Gll^Fp, Gll^Fp, Gll^Fp, Gll^Fp, Gll^Fp, Gll^Fp, Gll^Fp, Gll^Fp, Gg, Gll^Fp, Gg^Ve, Gll^Fp, Gll^Fp, Gll^Fp, Gll^Fp, Gll^Fp, Gll^Fp, Gg, Gg^Efm, Gg^Efm, Gll^Fp, Gll^Fp, Gg, Gll^Fp, Gll^Fp, Gll^Fp, Gll^Fp, Gll^Fp, Ce, Gll^Fp, Gll^Fp, Gll^Fp, Gll^Fp, Gs^Fds, Gs^Fds, Gg
Gll^Fp, Gg^Ve, Gg, Gll^Fp, Gg, Gll^Fp, Gll^Fp, Gll^Fp, Gll^Efm, Gll^Fp, Gg^Fet, Gg, Gll^Fp, Gg, Gg^Ve, Gll^Fp, Gg, Gg, Gll^Fp, Gg, Gg, Gll^Fp, Gll^Fp, Gll^Fp, Gll^Fp, Gll^Fp, Gg^Fet, Gg, Gll^Fp, Gg^Ve, Gll^Fp, Gll^Fp, Gll^Fp, Gll^Fp, Gll^Fp, Gll^Fp, Gll^Fp, Gll^Fp, Gll^Fp, Gg, Gll^Fp, Gg, Gs^Fds, Gll^Fp, Gg
Gg, Gll^Fp, Gll^Fp, Gll^Fp, Gll^Fp, Gll^Fp, Gg, Gg^Efm, Gg^Ve, Gg^Efm, Gg, Gg, Gll^Fp, Gll^Fp, Gll^Fp, Gg^Fet, Gll^Fp, Gll^Fp, Gll^Fp, Gll^Fp, Gg^Efm, Gll^Fp, Gll^Fp, Gll^Fp, Gll^Fp, Gll^Fp, Gll^Fp, Gg^Efm, Gll^Fp, Gll^Fp, Gll^Fp, Gll^Fp, Gg^Fet, Gll^Fp, Gg, Gll^Fp, Gll^Fp, Gs^Fds, Gs^Fds, Gll^Fp, Gll^Fp, Gg, Gll^Fp, Gs^Fds, Gg
Gll^Fp, Gg, Gll^Fp, Gg, Gg, Gll^Fp, Gll^Fp, Gll^Fp, Gs^Fds, Gll^Fp, Gll^Fp, Gg, Gg, Gll^Fp, Gll^Fp, Gg, Gs^Fds, Gs^Fds, Gll^Fp, Gll^Fp, Gg^Efm, Gll^Fp, Gg, Gll^Fp, Gll^Fp, Gll^Fp, Gll^Fp, Gll^Fp, Gll^Fp, Gll^Fp, Gll^Fp, Gll^Fp, Gll^Fp, Gll^Fp, Gll^Fp, Gll^Fp, Gs^Fds, Gs^Fds, Gll^Fp, Gll^Fp, Gg^Fet, Gg^Ve, Gll^Fp, Gs^Fds, Gg
Gll^Fp, Gll^Fp, Gll^Fp, Gg^Ve, Gll^Fp, Gll^Fp, Gll^Fp, Gs^Fds, Gs^Fds, Gg, Gg, Gll^Fp, Gg, Gll^Fp, Gll^Fp, Gs^Fds, Gs^Fds, Gs^Fds, Gll^Fp, Gg^Efm, Gll^Fp, Gg, Gg, Gll^Fp, Gg, Gg, Gg, Gll^Fp, Gg, Gll^Fp, Gg, Gg, Gg, Gll^Fp, Gg, Gll^Fp, Gs^Fds, Gs^Fds, Gll^Fp, Gll^Fp, Gll^Fp, Gll^Fp, Gll^Fp, Gs^Fds, Gg
Gg, Gg, Gg^Fet, Gll^Fp, Gll^Fp, Gg^Fet, Gll^Fp, Gs^Fds, Gs^Fds, Gg^Fet, Gll^Fp, Gll^Fp, Gs^Fds, Gs^Fds, Gll^Fp, Gll^Fp, Gs^Fds, Gll^Fp, Gll^Fp, Gll^Fp, Gg, Gll^Fp, Gg, Gg, Gg, Gg, Gg, Gg, Gg, Gg, Gg, Gg, Gg, Gg, Gg, Gg, Gg, Gll^Fp, Gg, Gll^Fp, Gg, Gll^Fp, Gll^Fp, Gll^Fp, Gg
Gg, Gg, Gg, Gll^Fp, Gll^Fp, Gll^Fp, Gll^Fp, Gs^Fds, Gs^Fds, Gs^Fds, Gll^Fp, Gll^Fp, Gs^Fds, Gs^Fds, Gll^Fp, Gs^Fds, Gs^Fds, Gs^Fds, Gll^Fp, Gg, Gg, Gg, Cv, Cv, Cv, Cv, Cv, Cv, Cv, Cv, Cv, Cv, Cv, Gg, Cv, Gg, Gg, Gll^Fp, Gll^Fp, Gll^Fp, Gll^Fp, Gll^Fp, Gll^Fp, Gll^Fp, Gg
Gg, Gll^Fp, Gll^Fp, Gg^Efm, Gg^Efm, Gll^Fp, Gg, Gll^Fp, Gg, Gll^Fp, Gll^Fp, Gll^Fp, Gs^Fds, Gs^Fds, Gll^Fp, Gll^Fp, Gll^Fp, Gll^Fp, Gg, Gg, Cv, Cv, Gg, Cv, Gg, Gg, Gg, Gg, Gg, Gg, Gg, Gg, Gg, Cv, Gg, Cv, Cv, Gg, Gg, Gg, Gg, Gll^Fp, Gg^Fet, Gll^Fp, Gg
Gg, Gll^Fp, Gll^Fp, Gll^Fp, Gg^Efm, Gll^Fp, Gg, Gg^Ve, Gll^Fp, Gg^Efm, Gg^Efm, Gll^Fp, Gll^Fp, Gll^Fp, Gll^Fp, Gg, Gg, Gg, Cv, Gg, Gg, Gg, Gg, Gg, Gg, Gg, Gg, Gg, Gg, Gg, Cv, Gg, Gg, Gg, Gg, Gg, Gg, Cv, Gg, Gg, Gg, Gll^Fp, Gll^Fp, Gll^Fp, Gg
Gg, Gll^Fp, Gll^Fp, Gll^Fp, Gll^Fp, Gs^Fds, Gs^Fds, Gs^Fds, Gs^Fds, Gll^Fp, Gll^Fp, Gg^Efm, Gll^Fp, Gg^Efm, Gll^Fp, Gg, Gg, Cv, Gg, Gg, Gg, Gg, Cv, Cv, Cv, Gg, Gg, Gg, Cv, Cv, Cv, Cv, Cv, Gg, Gg, Gg, Gg, Gg, Gg, Gg, Gg, Gll^Fp, Gs^Fds, Gll^Fp, Gg
Gg, Gg, Gg^Ve, Gll^Fp, Gs^Fds, Gs^Fds, Gs^Fds, Gg, Gg, Gll^Fp, Gg, Gll^Fp, Gg^Efm, Gll^Fp, Gg^Efm, Gg, Gg, Cv, Gg, Gg, Cv, Cv, Cv, Cv, Cv, Cv, Cv, Gg, Cv, Cv, Cv, Cv, Cv, Cv, Cv, Gg, Gg, Cv, Gg, Gg, Gs^Fds, Gs^Fds, Gs^Fds, Gll^Fp, Gg
Gll^Fp, Gll^Fp, Gll^Fp, Gll^Fp, Gll^Fp, Gs^Fds, Gll^Fp, Gll^Fp, Gg, Gg, Gg, Gll^Fp, Gll^Fp, Gll^Fp, Gll^Fp, Gg, Gg, Cv, Gg, Gg, Cv, Cv, Cv, Cv, Cv, Cv, Cv, Gg, Cv, Cv, Cv, Cv, Cv, Cv, Cv, Gg, Gg, Cv, Gg, Gg, Gs^Fds, Gs^Fds, Gs^Fds, Gll^Fp, Gg
Gll^Fp, Gll^Fp, Gll^Fp, Gll^Fp, Gg, Gll^Fp, Gll^Fp, Gg, Gs^Fds, Gs^Fds, Gs^Fds, Gg, Gll^Fp, Gll^Fp, Gll^Fp, Gg, Gg, Cv, Gg, Gg, Cv, Cv, Cv, 1 Kv, Cv, Cv, Cv, Gg, Cv, Cv, Cv, 2 Kv, Cv, Cv, Cv, Gg, Gg, Cv, Gg, Gg, Gll^Fp, Gs^Fds, Gs^Fds, Gs^Fds, Gg
Gll^Fp, Gll^Fp, Gg^Efm, Gll^Fp, Gs^Fds, Gg, Gs^Fds, Gs^Fds, Gll^Fp, Gll^Fp, Gll^Fp, Gs^Fds, Gg, Gll^Fp, Gll^Fp, Gg, Gg, Cv, Gg, Gg, Gg, Cv, Cv, Cv, Cv, Cv, Gg, Gg, Gg, Cv, Cv, Cv, Cv, Cv, Gg, Gg, Cv, Cv, Gg, Gll^Fp, Gg^Ve, Gll^Fp, Gll^Fp, Gll^Fp, Gg
Gg, Gg, Gll^Fp, Gg^Efm, Gs^Fds, Gs^Fds, Gll^Fp, Gg, Gg, Gll^Fp, Gg, Gs^Fds, Gs^Fds, Gg, Gll^Fp, Gll^Fp, Gll^Fp, Gg, Cv, Gg, Gg, Gg, Gg, Cv, Gg, Gg, Gg, Gg, Gg, Gg, Gg, Cv, Gg, Gg, Gg, Gg, Gg, Gg, Gg, Gll^Fp, Gll^Fp, Gg^Fet, Gll^Fp, Gll^Fp, Gg
Gg, Gg, Gg, Gll^Fp, Gll^Fp, Gll^Fp, Gll^Fp, Gll^Fp, Gll^Fp, Gg^Fet, Gs^Fds, Gs^Fds, Gll^Fp, Gg, Gll^Fp, Gll^Fp, Gll^Fp, Gg, Gg, Cv, Cv, Gg, Gg, Gg, Cv, Gg, Cv, Cv, Cv, Gg, Gg, Gg, Gg, Gg, Cv, Cv, Gg, Gll^Fp, Gg, Gg, Gs^Fds, Gll^Fp, Gll^Fp, Gg, Gg
Gg, Gll^Fp, Gll^Fp, Gll^Fp, Gll^Fp, Gll^Fp, Gll^Fp, Gll^Fp, Gg, Gs^Fds, Gll^Fp, Gg, Gll^Fp, Gg, Gll^Fp, Gll^Fp, Gg^Efm, Gg, Gg, Gg, Gg, Cv, Cv, Cv, Gg, Cv, Gg, Cv, Gg, Cv, Cv, Cv, Cv, Cv, Gg, Gg, Gll^Fp, Gll^Fp, Gg, Gll^Fp, Gs^Fds, Gll^Fp, Gll^Fp, Gll^Fp, Gll^Fp
Gg, Gll^Fp, Gg, Gs^Fds, Gs^Fds, Gll^Fp, Gg, Gs^Fds, Gs^Fds, Gg, Gll^Fp, Gg, Gg, Gg, Gll^Fp, Gll^Fp, Gll^Fp, Gg^Efm, Gg^Efm, Gg, Gll^Fp, Gg, Gg, Gg, Gg, Gg, Gg, Gg, Gg, Gg, Gg, Gg, Gg, Gg, Gg, Gg, Gg^Efm, Gg, Gll^Fp, Gg, Gs^Fds, Gll^Fp, Gg, Gll^Fp, Gll^Fp
Gg, Gll^Fp, Gg, Gs^Fds, Gs^Fds, Gs^Fds, Gs^Fds, Gs^Fds, Gs^Fds, Gll^Fp, Gll^Fp, Gll^Fp, Gll^Fp, Gg, Gll^Fp, Gll^Fp, Gll^Fp, Gll^Fp, Gll^Fp, Gll^Fp, Gll^Fp, Gll^Fp, Gll^Fp, Gg, Gg, Gg, Gll^Fp, Gg, Gg, Gg, Gg, Gg, Gg, Gg, Gg^Efm, Gg^Efm, Gll^Fp, Gll^Fp, Gll^Fp, Gs^Fds, Gs^Fds, Gg^Ve, Gg, Gll^Fp, Gg
Gg, Gg, Gg^Efm, Gll^Fp, Gs^Fds, Gg, Gll^Fp, Gg, Gll^Fp, Gll^Fp, Gll^Fp, Gg, Gg^Fet, Gll^Fp, Gg, Gg, Gll^Fp, Gg, Gg, Gll^Fp, Gll^Fp, Gll^Fp, Gg, Gll^Fp, Gll^Fp, Gll^Fp, Gll^Fp, Gll^Fp, Gll^Fp, Gg, Gg, Gg, Gll^Fp, Gg, Gg^Efm, Gg^Efm, Gll^Fp, Gll^Fp, Gg, Gg, Gll^Fp, Gs^Fds, Gs^Fds, Gll^Fp, Gg
Gg^Efm, Gg^Efm, Gg^Efm, Gg^Efm, Gll^Fp, Gs^Fds, Gs^Fds, Gll^Fp, Gg^Ve, Gll^Fp, Gg^Fet, Gll^Fp, Gll^Fp, Gll^Fp, Gs^Fds, Gs^Fds, Gs^Fds, Gll^Fp, Gll^Fp, Gll^Fp, Gll^Fp, Gll^Fp, Gg, Gll^Fp, Gg, Gll^Fp, Gg, Gll^Fp, Gll^Fp, Gll^Fp, Gll^Fp, Gg^Fet, Gg, Gll^Fp, Gll^Fp, Gll^Fp, Gll^Fp, Gll^Fp, Gll^Fp, Gll^Fp, Gs^Fds, Gs^Fds, Gg^Fet, Gll^Fp, Gll^Fp
Gll^Fp, Gll^Fp, Gll^Fp, Gll^Fp, Gll^Fp, Gll^Fp, Gg, Gs^Fds, Gs^Fds, Gg, Gg, Gll^Fp, Gll^Fp, Gll^Fp, Gs^Fds, Gs^Fds, Gll^Fp, Gs^Fds, Gs^Fds, Gll^Fp, Gg^Fet, Gll^Fp, Gll^Fp, Gg, Gll^Fp, Gg, Gg, Gll^Fp, Gll^Fp, Gll^Fp, Gll^Fp, Gll^Fp, Gll^Fp, Gll^Fp, Gs^Fds, Gll^Fp, Gll^Fp, Gll^Fp, Gg^Efm, Gs^Fds, Gs^Fds, Gg, Gll^Fp, Gll^Fp, Gll^Fp
Gll^Fp, Gll^Fp, Gll^Fp, Gll^Fp, Gll^Fp, Gg, Gs^Fds, Gs^Fds, Gg, Gg, Gs^Fds, Gg, Gll^Fp, Gg, Gll^Fp, Gg, Gll^Fp, Gg, Gs^Fds, Gs^Fds, Gll^Fp, Gll^Fp, Gg^Fet, Gll^Fp, Gll^Fp, Gg, Gll^Fp, Gll^Fp, Gs^Fds, Gs^Fds, Gll^Fp, Gg^Ve, Gs^Fds, Gs^Fds, Gs^Fds, Gs^Fds, Gll^Fp, Gg^Efm, Gll^Fp, Gs^Fds, Gs^Fds, Gs^Fds, Gll^Fp, Gg, Gll^Fp
Gll^Fp, Gll^Fp, Gg, Gg, Gg^Efm, Gs^Fds, Gs^Fds, Gll^Fp, Gs^Fds, Gs^Fds, Gs^Fds, Gll^Fp, Gg, Gg, Gs^Fds, Gll^Fp, Gll^Fp, Gg, Gs^Fds, Gs^Fds, Gll^Fp, Gll^Fp, Gg, Gll^Fp, Gg, Gll^Fp, Gs^Fds, Gs^Fds, Gg, Gs^Fds, Gs^Fds, Gll^Fp, Gs^Fds, Gs^Fds, Gg, Gs^Fds, Gll^Fp, Gll^Fp, Gll^Fp, Gll^Fp, Gll^Fp, Gs^Fds, Gll^Fp, Gll^Fp, Gll^Fp
Gg, Gll^Fp, Gll^Fp, Gll^Fp, Gg^Efm, Gg^Efm, Gg^Ve, Gs^Fds, Gs^Fds, Gs^Fds, Gg^Fet, Gs^Fds, Gs^Fds, Gs^Fds, Gll^Fp, Gg, Gll^Fp, Gll^Fp, Gs^Fds, Gs^Fds, Gs^Fds, Gll^Fp, Gll^Fp, Gg, Gll^Fp, Gg, Gg, Gll^Fp, Gll^Fp, Gll^Fp, Gs^Fds, Gll^Fp, Gs^Fds, Gll^Fp, Gll^Fp, Gll^Fp, Gg^Ve, Gll^Fp, Gll^Fp, Gll^Fp, Gll^Fp, Gg^Efm, Gll^Fp, Gg, Gll^Fp
Gll^Fp, Gg^Ve, Gll^Fp, Gll^Fp, Gll^Fp, Gs^Fds, Gll^Fp, Gll^Fp, Gll^Fp, Gll^Fp, Gll^Fp, Gll^Fp, Gll^Fp, Gll^Fp, Gg, Gll^Fp, Gll^Fp, Gll^Fp, Gg, Gs^Fds, Gll^Fp, Gll^Fp, Gll^Fp, Gll^Fp, Gg, Gll^Fp, Gg, Gll^Fp, Gg, Gs^Fds, Gg, Gll^Fp, Gll^Fp, Gg^Fet, Gs^Fds, Gg, Gg, Gll^Fp, Gll^Fp, Gg^Efm, Gg^Efm, Gll^Fp, Gg^Ve, Gg, Gg
Gll^Fp, Gll^Fp, Gg, Gll^Fp, Gg, Gg, Gg, Gll^Fp, Gg, Gg, Gll^Fp, Gll^Fp, Gll^Fp, Gll^Fp, Gg, Gll^Fp, Gg, Gll^Fp, Gll^Fp, Gll^Fp, Gll^Fp, Gs^Fds, Gs^Fds, Gg^Ve, Gll^Fp, Gg, Gg, Gg, Gg, Gs^Fds, Gg, Gg, Gll^Fp, Gs^Fds, Gll^Fp, Gll^Fp, Gll^Fp, Gg, Gg, Gg, Gg, Gll^Fp, Gll^Fp, Gg, Gg
Gll^Fp, Gll^Fp, Gg, Gg, Ce, Gg, Gg, Gg, Gll^Fp, Gll^Fp, Gs^Fds, Gll^Fp, Gg, Gg, Gll^Fp, Gg, Gll^Fp, Gll^Fp, Gll^Fp, Gll^Fp, Gll^Fp, Gs^Fds, Gs^Fds, Gs^Fds, Gs^Fds, Gg, Gll^Fp, Gg, Gg^Ve, Gll^Fp, Gs^Fds, Gll^Fp, Gg, Gll^Fp, Gll^Fp, Gg^Ve, Gg, Gll^Fp, Ce, Gll^Fp, Ce, Gll^Fp, Ce, Gll^Fp, Gll^Fp
Gll^Fp, Gg, Ce, Gll^Fp, Ce, Gll^Fp, Ce, Gg, Gg, Gll^Fp, Gs^Fds, Gll^Fp, Gll^Fp, Gs^Fds, Gs^Fds, Gg, Gll^Fp, Gll^Fp, Gll^Fp, Gll^Fp, Gg^Ve, Gll^Fp, Gs^Fds, Gs^Fds, Gs^Fds, Gg, Gll^Fp, Gg, Gg, Gs^Fds, Gg^Efm, Gs^Fds, Gg, Gll^Fp, Gll^Fp, Gll^Fp, Gg, Gg, Gll^Fp, Ce, Ce, Ce, Gll^Fp, Gg, Gg
Gll^Fp, Gll^Fp, Gll^Fp, Ce, 6 Ke, Ce, Gll^Fp, Ce, Gll^Fp, Gg^Ve, Gs^Fds, Gs^Fds, Gs^Fds, Gg, Gs^Fds, Gg, Gg, Gll^Fp, Gll^Fp, Gg^Efm, Gg^Efm, Gll^Fp, Gs^Fds, Gs^Fds, Gs^Fds, Gll^Fp, Gll^Fp, Gll^Fp, Gs^Fds, Gs^Fds, Gs^Fds, Gs^Fds, Gll^Fp, Gll^Fp, Gll^Fp, Gg^Efm, Gg^Efm, Gg, Ce, Ce, 5 Ke, Ce, Gll^Fp, Gg, Gg
Gg, Gg, Ce, Ce, Ce, Ce, Gll^Fp, Gll^Fp, Gg, Gll^Fp, Gll^Fp, Gll^Fp, Gs^Fds, Gs^Fds, Gs^Fds, Gs^Fds, Gs^Fds, Gll^Fp, Gll^Fp, Gg^Efm, Gll^Fp, Gll^Fp, Gll^Fp, Gs^Fds, Gll^Fp, Gll^Fp, Gll^Fp, Gs^Fds, Gs^Fds, Gs^Fds, Gs^Fds, Gg, Gg, Gll^Fp, Gg, Gll^Fp, Gll^Fp, Gll^Fp, Ce, Ce, Ce, Ce, Ce, Gg, Gg
Gll^Fp, Gll^Fp, Gll^Fp, Ce, Gll^Fp, Ce, Gll^Fp, Gll^Fp, Gll^Fp, Gll^Fp, Gs^Fds, Gs^Fds, Gs^Fds, Gs^Fds, Gll^Fp, Gs^Fds, Gs^Fds, Gll^Fp, Gg, Gll^Fp, Gll^Fp, Gg, Gll^Fp, Gs^Fds, Gs^Fds, Gs^Fds, Gs^Fds, Gs^Fds, Gs^Fds, Gs^Fds, Gs^Fds, Gs^Fds, Gs^Fds, Gll^Fp, Gll^Fp, Gg^Ve, Gll^Fp, Gll^Fp, Gll^Fp, Ce, Gll^Fp, Gll^Fp, Gg, Gg, Gg
Gg, Gg, Gg, Gg, Gg, Gll^Fp, Gg, Gll^Fp, Gg, Gll^Fp, Gll^Fp, Gs^Fds, Gll^Fp, Gg, Gll^Fp, Gs^Fds, Gg, Gll^Fp, Gg, Gll^Fp, Gll^Fp, Gll^Fp, Gll^Fp, Gll^Fp, Gll^Fp, Gll^Fp, Gg, Gs^Fds, Gg, Gll^Fp, Gg, Gg, Gg, Gs^Fds, Gg, Gg, Gg, Gll^Fp, Gll^Fp, Gll^Fp, Gll^Fp, Gll^Fp, Gll^Fp, Gll^Fp, Gg
