Gg, Gg, Gs^Fds, Gg, Gs^Fds, Gg, Gs^Fds, Gg, Gll^Fp, Gll^Fp, Gs^Fds, Gll^Fp, Gg, Gll^Fp, Gg, Gg, Gg, Gg, Gg, Gg, Gg, Gg, Gs^Fds, Gg, Gg, Gg, Gg, Gg, Gg, Gs^Fds, Gs^Fds, Gs^Fds, Gg, Gs^Fds, Gs^Fds, Gs^Fds, Gg, Gg, Gg, Gg, Gs^Fds, Gg, Ce, Gg, Gs^Fds, Gg, Gg
Gs^Fds, Gg, Gll^Fp, Gg, Gll^Fp, Gs^Fds, Gg^Ve, Gg, Gs^Fds, Gg, Gg, Gs^Fds, Gs^Fds, Gg, Gs^Fds, Gll^Fp, Gll^Fp, Gs^Fds, Gg, Gs^Fds, Gs^Fds, Gs^Fds, Gg, Gs^Fds, Gs^Fds, Gs^Fds, Gs^Fds, Gs^Fds, Gs^Fds, Gs^Fds, Gg, Gg, Gs^Fds, Gg, Gg, Gs^Fds, Gg, Gg, Gg, Gg, Ce, Gs^Fds, Ce, Gs^Fds, Gg, Gg, Gg
Gs^Fds, Gll^Fp, Gs^Fds, Gll^Fp, Gll^Fp, Gll^Fp, Gs^Fds, Gs^Fds, Gll^Fp, Gg, Gg, Gs^Fds, Gs^Fds, Gs^Fds, Gg, Gs^Fds, Gg, Gs^Fds, Gg, Gs^Fds, Gll^Fp, Gs^Fds, Gs^Fds, Gs^Fds, Gs^Fds, Gg, Gs^Fds, Gs^Fds, Gg, Gg, Gs^Fds, Gg, Gs^Fds, Gs^Fds, Gs^Fds, Gs^Fds, Gll^Fp, Gs^Fds, Gs^Fds, Gg^Ve, Gs^Fds, Ce, 3 Ke, Ce, Ce, Gg, Gg
Gll^Fp, Gll^Fp, Ce, Gs^Fds, Gll^Fp, Gs^Fds, Gs^Fds, Gg, Gs^Fds, Gg^Fet, Gg^Fet, Gs^Fds, Gs^Fds, Gs^Fds, Gll^Fp, Gs^Fds, Gg^Fet, Gll^Fp, Gg^Fet, Gg, Gll^Fp, Gll^Fp, Gll^Fp, Gg, Gs^Fds, Gs^Fds, Gs^Fds, Gs^Fds, Gs^Fds, Gs^Fds, Gs^Fds, Gs^Fds, Gs^Fds, Gs^Fds, Gs^Fds, Gll^Fp, Gg, Gll^Fp, Gll^Fp, Gs^Fds, Gg^Fet, Ce, Ce, Ce, Ce, Gg, Gg
Gll^Fp, Ce, 4 Ke, Ce, Gg^Fet, Gll^Fp, Gs^Fds, Gll^Fp, Gg^Ve, Gs^Fds, Gg, Gll^Fp, Gs^Fds, Gs^Fds, Gs^Fds, Gs^Fds, Gs^Fds, Gs^Fds, Gg, Gll^Fp, Gs^Fds, Gs^Fds, Gll^Fp, Gll^Fp, Gs^Fds, Gs^Fds, Gg^Fet, Gs^Fds, Gs^Fds, Gs^Fds, Gs^Fds, Gs^Fds, Gs^Fds, Gs^Fds, Gll^Fp, Gs^Fds, Gg^Ve, Gll^Fp, Gll^Fp, Gll^Fp, Gll^Fp, Gs^Fds, Gs^Fds, Gg^Fet, Ce, Gs^Fds, Gs^Fds
Gll^Fp, Ce, Ce, Ce, Ce, Gg, Gll^Fp, Gs^Fds, Gg, Gs^Fds, Gs^Fds, Gs^Fds, Gll^Fp, Gs^Fds, Gs^Fds, Gs^Fds, Gll^Fp, Gll^Fp, Gll^Fp, Gll^Fp, Gg, Gg, Gs^Fds, Gs^Fds, Gs^Fds, Gs^Fds, Gs^Fds, Gg, Gll^Fp, Gs^Fds, Gg, Gll^Fp, Gg^Fet, Gll^Fp, Gs^Fds, Gs^Fds, Gs^Fds, Gs^Fds, Gll^Fp, Gs^Fds, Gs^Fds, Gs^Fds, Gs^Fds, Gg^Ve, Gs^Fds, Gs^Fds, Gs^Fds
Gg, Ce, Gg^Ve, Ce, Gs^Fds, Gs^Fds, Gs^Fds, Gll^Fp, Gs^Fds, Gg^Fet, Gs^Fds, Gs^Fds, Gll^Fp, Gll^Fp, Gs^Fds, Gs^Fds, Gs^Fds, Gs^Fds, Gll^Fp, Gs^Fds, Gll^Fp, Gg, Gll^Fp, Gll^Fp, Gs^Fds, Gs^Fds, Gs^Fds, Gs^Fds, Gs^Fds, Gg^Fet, Gs^Fds, Gg, Gs^Fds, Gg, Gs^Fds, Gs^Fds, Gll^Fp, Gll^Fp, Gs^Fds, Gs^Fds, Gg^Fet, Gs^Fds, Gg, Gs^Fds, Gs^Fds, Gs^Fds, Gs^Fds
Gg, Ce, Gs^Fds, Gll^Fp, Gg^Fet, Gll^Fp, Gll^Fp, Gll^Fp, Gll^Fp, Gs^Fds, Gll^Fp, Gg^Ve, Gs^Fds, Gll^Fp, Gg, Gll^Fp, Gs^Fds, Gll^Fp, Gs^Fds, Gg^Fet, Gll^Fp, Gll^Fp, Gg^Fet, Gs^Fds, Gg^Ve, Gs^Fds, Gs^Fds, Gs^Fds, Gs^Fds, Gll^Fp, Gll^Fp, Gll^Fp, Gll^Fp, Gll^Fp, Gg, Gll^Fp, Gs^Fds, Gs^Fds, Gll^Fp, Gll^Fp, Gll^Fp, Gll^Fp, Gll^Fp, Gs^Fds, Gs^Fds, Gs^Fds, Gs^Fds
Gg, Gs^Fds, Gg, Gs^Fds, Gll^Fp, Gg^Ve, Gs^Fds, Gs^Fds, Gs^Fds, Gll^Fp, Gll^Fp, Gll^Fp, Gg, Gg, Gg^Fet, Gs^Fds, Gs^Fds, Gs^Fds, Gll^Fp, Gs^Fds, Gll^Fp, Gll^Fp, Gs^Fds, Gg, Gll^Fp, Gs^Fds, Gll^Fp, Gg, Gll^Fp, Gll^Fp, Gs^Fds, Gll^Fp, Gll^Fp, Gg, Gll^Fp, Gll^Fp, Gll^Fp, Gll^Fp, Gg^Ve, Gs^Fds, Gg, Gg, Gll^Fp, Gg^Ve, Gg^Fet, Gs^Fds, Gs^Fds
Gg, Gs^Fds, Gg, Gs^Fds, Gll^Fp, Gs^Fds, Gs^Fds, Gs^Fds, Gll^Fp, Gg, Gs^Fds, Gs^Fds, Gs^Fds, Gll^Fp, Gs^Fds, Gg, Gs^Fds, Gs^Fds, Gs^Fds, Gg, Gll^Fp, Gs^Fds, Gll^Fp, Gs^Fds, Gg, Gs^Fds, Gs^Fds, Gg, Gs^Fds, Gg, Gg, Gg, Gll^Fp, Gll^Fp, Gg, Gll^Fp, Gg, Gg^Fet, Gs^Fds, Gll^Fp, Gs^Fds, Gs^Fds, Gll^Fp, Gg, Gg, Gs^Fds, Gs^Fds
Gg, Gs^Fds, Gs^Fds, Gs^Fds, Gs^Fds, Gll^Fp, Gs^Fds, Gs^Fds, Gll^Fp, Gs^Fds, Gg, Gs^Fds, Gs^Fds, Gg, Gll^Fp, Gg, Gll^Fp, Gs^Fds, Gs^Fds, Gg, Gg^Ve, Gs^Fds, Gg, Gll^Fp, Gll^Fp, Gs^Fds, Gs^Fds, Gs^Fds, Gs^Fds, Gs^Fds, Gs^Fds, Gg, Gll^Fp, Gg^Ve, Gll^Fp, Gg, Gg, Gg, Gg, Gll^Fp, Gll^Fp, Gs^Fds, Gll^Fp, Gg, Gs^Fds, Gs^Fds, Gs^Fds
Gg, Gg^Ve, Gs^Fds, Gs^Fds, Gs^Fds, Gll^Fp, Gg^Fet, Gll^Fp, Gll^Fp, Gg, Gs^Fds, Gg, Gg, Gg^Fet, Gll^Fp, Gll^Fp, Gll^Fp, Gll^Fp, Gll^Fp, Gll^Fp, Gs^Fds, Gs^Fds, Gs^Fds, Gs^Fds, Gs^Fds, Gll^Fp, Gg^Ve, Gll^Fp, Gll^Fp, Gg^Ve, Gll^Fp, Gll^Fp, Gs^Fds, Gs^Fds, Gll^Fp, Gs^Fds, Gll^Fp, Gg, Gg, Gg^Ve, Gs^Fds, Gll^Fp, Gs^Fds, Gs^Fds, Gg^Fet, Gs^Fds, Gg
Gg, Gs^Fds, Gg, Gs^Fds, Gs^Fds, Gs^Fds, Gs^Fds, Gs^Fds, Gll^Fp, Gs^Fds, Gs^Fds, Gg, Gs^Fds, Gs^Fds, Gs^Fds, Gg, Gs^Fds, Gs^Fds, Gg, Gs^Fds, Gs^Fds, Gs^Fds, Gg, Gg, Gg, Gg, Gg, Gg, Gg, Gg, Gg, Gs^Fds, Gs^Fds, Gs^Fds, Gg, Gll^Fp, Gg, Gll^Fp, Gll^Fp, Gll^Fp, Gll^Fp, Gll^Fp, Gll^Fp, Gs^Fds, Gll^Fp, Gg, Gg
Gg, Gs^Fds, Gg, Gs^Fds, Gs^Fds, Gg, Gg, Gs^Fds, Gll^Fp, Gs^Fds, Gg, Gs^Fds, Gll^Fp, Gs^Fds, Gs^Fds, Gs^Fds, Gg, Gg, Gs^Fds, Gg, Gs^Fds, Gs^Fds, Gg, Gg, Gg, Gg, Cv, Cv, Gg, Cv, Cv, Gg, Gg, Gg, Gg, Gg, Gs^Fds, Gg^Fet, Gg, Gs^Fds, Gs^Fds, Gs^Fds, Gs^Fds, Gll^Fp, Gll^Fp, Gs^Fds, Gs^Fds
Gg, Gs^Fds, Gg, Gs^Fds, Gs^Fds, Gg, Gs^Fds, Gs^Fds, Gll^Fp, Gs^Fds, Gg, Gll^Fp, Gs^Fds, Gs^Fds, Gs^Fds, Gs^Fds, Gs^Fds, Gg, Gs^Fds, Gg, Gs^Fds, Gg, Gg, Gg, Cv, Cv, Gg, Gg, Gg, Gg^Ve, Gg, Cv, Cv, Gg, Gg, Gs^Fds, Gs^Fds, Gg, Gg^Ve, Gg, Gs^Fds, Gs^Fds, Gll^Fp, Gs^Fds, Gll^Fp, Gll^Fp, Gg
Gg, Gs^Fds, Gs^Fds, Gs^Fds, Gs^Fds, Gs^Fds, Gs^Fds, Gs^Fds, Gs^Fds, Gll^Fp, Gg, Gg, Gg, Gg, Gs^Fds, Gs^Fds, Gs^Fds, Gg^Ve, Gg, Gs^Fds, Gg, Gg, Cv, Cv, Gg^Ve, Gg, Gg, Gg, Cv, Gg, Gg, Gg, Gg^Ve, Cv, Cv, Gg, Gg, Gs^Fds, Gs^Fds, Gs^Fds, Gg^Ve, Gll^Fp, Gg, Gll^Fp, Gll^Fp, Gg, Gg
Gg, Gg, Gg, Gs^Fds, Gg, Gg^Fet, Gs^Fds, Gg, Gg, Gs^Fds, Gs^Fds, Gs^Fds, Gs^Fds, Gll^Fp, Gll^Fp, Gs^Fds, Gs^Fds, Gs^Fds, Gg, Gg, Gg, Gg, Gg, Gg, Gg, Gg, Cv, Cv, Cv, Cv, Cv, Gg, Gg, Gg, Gg^Ve, Gg, Gg, Gg, Gs^Fds, Gg, Gg, Gll^Fp, Gg, Gg^Fet, Gs^Fds, Gll^Fp, Gll^Fp
Gg, Gll^Fp, Gll^Fp, Gs^Fds, Gs^Fds, Gs^Fds, Gs^Fds, Gg, Gs^Fds, Gll^Fp, Gg, Gll^Fp, Gs^Fds, Gs^Fds, Gs^Fds, Gg, Gs^Fds, Gs^Fds, Gg, Gg, Gg, Gg, Cv, Gg^Ve, Gg, Cv, Cv, Cv, Cv, Cv, Cv, Cv, Cv, Gg, Gg, Cv, Gg, Gg, Gs^Fds, Gs^Fds, Gg^Fet, Gs^Fds, Gs^Fds, Gg^Ve, Gs^Fds, Gg, Gll^Fp
Gg, Gll^Fp, Gll^Fp, Gg^Ve, Ce, Gg, Gs^Fds, Gs^Fds, Gll^Fp, Gg, Gg, Gs^Fds, Gg, Gs^Fds, Gll^Fp, Gll^Fp, Gg, Gs^Fds, Gg, Gg, Gs^Fds, Gg, Cv, Gg, Gg, Cv, Cv, Cv, 2 Kv, Cv, Cv, Cv, Cv, Gg, Gg, Cv, Gg, Gg, Gg, Gs^Fds, Gs^Fds, Gll^Fp, Gll^Fp, Gs^Fds, Gll^Fp, Gll^Fp, Gs^Fds
Gg, Gll^Fp, Gs^Fds, Gll^Fp, Ce, Ce, Gg, Gll^Fp, Gs^Fds, Gs^Fds, Gs^Fds, Gg, Gs^Fds, Gg, Gll^Fp, Gg, Gg, Gg^Ve, Gg, Gs^Fds, Gs^Fds, Gg, Cv, Gg, Gg, Cv, Cv, Cv, Cv, Cv, Cv, Cv, Cv, Gg, Gg, Cv, Gg, Gg, Gg, Gs^Fds, Gs^Fds, Gll^Fp, Gs^Fds, Gll^Fp, Gs^Fds, Gll^Fp, Gs^Fds
Gg, Gs^Fds, Ce, Ce, Gll^Fp, Gll^Fp, Gg, Gg^Ve, Gs^Fds, Gs^Fds, Gs^Fds, Gg, Gs^Fds, Gll^Fp, Gg, Gg, Gg, Gs^Fds, Gg, Gg, Gg, Gg, Cv, Gg^Ve, Gg, Cv, Cv, Cv, Cv, Cv, Cv, Cv, Gg, Gg, Gg^Ve, Cv, Gs^Fds, Gs^Fds, Gll^Fp, Gll^Fp, Gg^Ve, Gll^Fp, Ce, Gg^Fet, Ce, Gs^Fds, Gg
Gg, Ce, 5 Ke, Ce, Gg^Fet, Gll^Fp, Gg, Gs^Fds, Gll^Fp, Gs^Fds, Gll^Fp, Gll^Fp, Gll^Fp, Gs^Fds, Gs^Fds, Gg, Gll^Fp, Gg, Gll^Fp, Gg, Gg, Gg, Cv, Gg, Gg, Gg^Ve, Gg, Cv, Cv, Cv, Gg, Gg, Gg, Gg, Cv, Gg, Gs^Fds, Gg, Gg, Gll^Fp, Ce, Ce, Ce, Ce, Ce, Gg, Gg
Gg, Ce, Ce, Ce, Gll^Fp, Gs^Fds, Gll^Fp, Gll^Fp, Gll^Fp, Gll^Fp, Gs^Fds, Gg, Gg, Gll^Fp, Gg, Gll^Fp, Gg^Ve, Gll^Fp, Gll^Fp, Gg, Gg, Gg, Gg, Gg, Cv, Gg, Gg, Gg, Gg, Gg, Gg, Gg^Ve, Cv, Cv, Gg, Gg, Gg, Gs^Fds, Gs^Fds, Gs^Fds, Ce, 6 Ke, Ce, Gg^Fet, Gll^Fp, Gg, Gs^Fds
Gs^Fds, Gs^Fds, Gs^Fds, Gs^Fds, Gs^Fds, Gll^Fp, Gs^Fds, Gg, Gg, Gg, Gg^Fet, Gg, Gs^Fds, Gg, Gg^Fet, Gs^Fds, Gll^Fp, Gll^Fp, Gs^Fds, Gg, Gg^Ve, Gg, Gg, Gg, Gg, Cv, Cv, Gg^Ve, Gg, Gg, Cv, Cv, Gg, Gg, Gg, Gll^Fp, Gll^Fp, Gs^Fds, Gg^Fet, Gll^Fp, Gll^Fp, Ce, Gll^Fp, Gs^Fds, Gs^Fds, Gll^Fp, Gs^Fds
Gs^Fds, Gg, Gg, Gg, Gg^Ve, Gs^Fds, Gs^Fds, Gs^Fds, Gs^Fds, Gg, Gg, Gg, Gll^Fp, Gll^Fp, Gg, Gs^Fds, Gg, Gs^Fds, Gs^Fds, Gg, Gg, Gg, Gg, Gg, Gg, Gg, Gg, Cv, Gg, Cv, Gg, Gg, Gg, Gg, Gs^Fds, Gs^Fds, Gll^Fp, Gs^Fds, Gs^Fds, Gs^Fds, Gg^Fet, Gs^Fds, Gs^Fds, Gs^Fds, Gs^Fds, Gll^Fp, Gg
Gg, Gs^Fds, Gs^Fds, Gg, Gs^Fds, Gg^Fet, Gs^Fds, Gg, Gll^Fp, Gs^Fds, Gll^Fp, Gs^Fds, Gll^Fp, Gll^Fp, Gg, Gs^Fds, Gs^Fds, Gg, Gll^Fp, Gs^Fds, Gll^Fp, Gs^Fds, Gs^Fds, Gg, Gs^Fds, Gg, Gg, Gg, Gs^Fds, Gg, Gg, Gg, Gs^Fds, Gs^Fds, Gs^Fds, Gs^Fds, Gll^Fp, Gs^Fds, Gs^Fds, Gs^Fds, Gll^Fp, Gs^Fds, Gll^Fp, Gll^Fp, Gg, Gg, Gg
Gg, Gs^Fds, Gs^Fds, Gs^Fds, Gs^Fds, Gs^Fds, Gll^Fp, Gs^Fds, Gll^Fp, Gll^Fp, Gs^Fds, Gll^Fp, Gll^Fp, Gg, Gg, Gg, Gg, Gg, Gll^Fp, Gll^Fp, Gg, Gll^Fp, Gs^Fds, Gll^Fp, Gll^Fp, Gs^Fds, Gll^Fp, Gs^Fds, Gg, Gs^Fds, Gs^Fds, Gs^Fds, Gg, Gg, Gs^Fds, Gs^Fds, Gs^Fds, Gs^Fds, Gll^Fp, Gs^Fds, Gs^Fds, Gs^Fds, Gg^Fet, Gs^Fds, Gs^Fds, Gg, Gg
Gg, Gs^Fds, Gs^Fds, Gs^Fds, Gg^Ve, Gg, Gll^Fp, Gll^Fp, Gll^Fp, Gs^Fds, Gs^Fds, Gs^Fds, Gs^Fds, Gs^Fds, Gs^Fds, Gs^Fds, Gg, Gg^Fet, Gg, Gll^Fp, Gll^Fp, Gll^Fp, Gg, Gll^Fp, Gs^Fds, Gll^Fp, Gll^Fp, Gll^Fp, Gll^Fp, Gg^Ve, Gs^Fds, Gs^Fds, Gg, Gg^Ve, Gll^Fp, Gs^Fds, Gg, Gll^Fp, Gg, Gg, Gs^Fds, Gs^Fds, Gll^Fp, Gs^Fds, Gg, Gs^Fds, Gg
Gg, Gs^Fds, Gll^Fp, Gll^Fp, Gll^Fp, Gll^Fp, Gll^Fp, Gll^Fp, Gll^Fp, Gll^Fp, Gll^Fp, Gg^Fet, Gll^Fp, Gll^Fp, Gs^Fds, Gs^Fds, Gs^Fds, Gs^Fds, Gg, Gs^Fds, Gg, Gll^Fp, Gs^Fds, Gg^Fet, Gg^Ve, Gg, Gs^Fds, Gs^Fds, Gs^Fds, Gll^Fp, Gs^Fds, Gs^Fds, Gg, Gg, Gg^Fet, Gg, Gs^Fds, Gg, Gg^Fet, Gll^Fp, Gll^Fp, Gs^Fds, Gll^Fp, Gll^Fp, Gs^Fds, Gs^Fds, Gg
Gg, Gs^Fds, Gll^Fp, Gs^Fds, Gs^Fds, Gs^Fds, Gs^Fds, Gs^Fds, Gll^Fp, Gs^Fds, Gll^Fp, Gs^Fds, Gg, Gs^Fds, Gll^Fp, Gll^Fp, Gs^Fds, Gs^Fds, Gs^Fds, Gs^Fds, Gs^Fds, Gll^Fp, Gs^Fds, Gs^Fds, Gg, Gs^Fds, Gg^Fet, Gs^Fds, Gs^Fds, Gll^Fp, Gll^Fp, Gll^Fp, Gs^Fds, Gs^Fds, Gg, Gg, Gg, Gg, Gll^Fp, Gs^Fds, Gll^Fp, Gll^Fp, Gs^Fds, Gg, Gs^Fds, Gg, Gg
Gg, Gg, Gll^Fp, Gll^Fp, Gs^Fds, Gll^Fp, Gll^Fp, Gs^Fds, Gs^Fds, Gs^Fds, Gs^Fds, Gll^Fp, Gll^Fp, Gg^Ve, Gll^Fp, Gll^Fp, Gll^Fp, Gs^Fds, Gll^Fp, Gs^Fds, Gs^Fds, Gs^Fds, Gs^Fds, Gg, Gs^Fds, Gg, Gs^Fds, Gll^Fp, Gs^Fds, Gs^Fds, Gg, Gs^Fds, Gs^Fds, Gs^Fds, Gs^Fds, Gg, Gll^Fp, Gg, Gs^Fds, Gll^Fp, Gs^Fds, Gll^Fp, Gll^Fp, Gll^Fp, Gs^Fds, Gs^Fds, Gg
Gs^Fds, Gs^Fds, Gg^Ve, Gll^Fp, Gll^Fp, Gll^Fp, Gs^Fds, Gs^Fds, Rb, Gs^Fds, Gs^Fds, Gs^Fds, Gs^Fds, Gll^Fp, Gs^Fds, Gll^Fp, Gll^Fp, Gs^Fds, Gs^Fds, Gll^Fp, Gll^Fp, Gll^Fp, Gll^Fp, Gs^Fds, Gs^Fds, Gs^Fds, Gg, Gs^Fds, Gs^Fds, Gs^Fds, Gs^Fds, Gg, Gg, Gg, Gll^Fp, Gs^Fds, Gs^Fds, Gs^Fds, Gs^Fds, Gs^Fds, Gll^Fp, Gll^Fp, Gg^Ve, Gs^Fds, Gs^Fds, Gs^Fds, Gll^Fp
Gg, Gs^Fds, Gs^Fds, Gs^Fds, Gs^Fds, Gs^Fds, Ce, Ce, Ce, Rb, Rb, Gs^Fds, Rb, Gg^Ve, Gs^Fds, Gs^Fds, Gs^Fds, Gll^Fp, Gs^Fds, Gs^Fds, Gll^Fp, Gll^Fp, Gg, Gll^Fp, Gs^Fds, Gs^Fds, Gg, Gg, Gs^Fds, Gll^Fp, Gll^Fp, Gs^Fds, Gll^Fp, Gs^Fds, Gll^Fp, Gs^Fds, Gs^Fds, Gs^Fds, Gs^Fds, Gg, Gll^Fp, Gll^Fp, Ce, Ce, Ce, Ce, Gs^Fds
Gg, Gs^Fds, Gs^Fds, Gs^Fds, Ce, Ce, Ce, Ce, Ce, Ce, Ce, Rb, Rb, Gs^Fds, Gs^Fds, Gg, Gg^Ve, Gs^Fds, Gs^Fds, Gg^Ve, Gs^Fds, Gll^Fp, Gs^Fds, Gs^Fds, Gs^Fds, Gs^Fds, Gg, Gg, Gll^Fp, Gg, Gs^Fds, Gs^Fds, Gg^Fet, Gll^Fp, Gll^Fp, Gs^Fds, Gs^Fds, Gs^Fds, Gs^Fds, Gll^Fp, Gll^Fp, Gs^Fds, Ce, Ce, 7 Ke, Ce, Gs^Fds
Gg, Gg^Ve, Gs^Fds, Rb, Ce, Ce, Ce, 1 Ke, Ce, Ce, Ce, Ce, Rb, Gs^Fds, Gg, Gs^Fds, Gg, Gs^Fds, Gs^Fds, Gs^Fds, Gs^Fds, Gs^Fds, Gs^Fds, Gll^Fp, Gg, Gs^Fds, Gll^Fp, Gll^Fp, Gll^Fp, Gll^Fp, Gll^Fp, Gg, Gll^Fp, Gll^Fp, Gg, Gs^Fds, Gll^Fp, Gll^Fp, Gs^Fds, Gs^Fds, Gll^Fp, Gg^Fet, Gg^Ve, Ce, Ce, Ce, Gs^Fds
Gs^Fds, Gs^Fds, Gs^Fds, Rb, Ce, Ce, Ce, Ce, Ce, Ce, Ce, Ce, Rb, Gs^Fds, Gs^Fds, Gg, Gll^Fp, Gs^Fds, Gs^Fds, Gs^Fds, Gs^Fds, Gs^Fds, Gs^Fds, Gg, Gg^Ve, Gg, Gs^Fds, Gg^Fet, Gs^Fds, Gll^Fp, Gll^Fp, Gll^Fp, Gll^Fp, Gs^Fds, Gll^Fp, Gs^Fds, Gs^Fds, Gll^Fp, Gll^Fp, Gg^Fet, Gll^Fp, Gg, Gs^Fds, Ce, Gll^Fp, Gll^Fp, Gll^Fp
Gg, Gg, Gs^Fds, Gs^Fds, Ce, Ce, Ce, Ce, Rb, Rb, Gs^Fds, Gs^Fds, Gs^Fds, Gs^Fds, Gs^Fds, Gs^Fds, Gll^Fp, Gll^Fp, Gll^Fp, Gll^Fp, Gll^Fp, Gll^Fp, Gs^Fds, Gs^Fds, Gs^Fds, Gg, Gg, Gs^Fds, Gs^Fds, Gg, Gs^Fds, Gs^Fds, Gll^Fp, Gg, Gll^Fp, Gg^Fet, Gll^Fp, Gs^Fds, Gs^Fds, Gs^Fds, Gll^Fp, Gg, Gs^Fds, Gll^Fp, Gg, Gs^Fds, Gg
Gg, Gg^Ve, Gg, Gs^Fds, Rb, Ce, Rb, Rb, Gs^Fds, Gs^Fds, Gs^Fds, Gs^Fds, Gg^Ve, Gs^Fds, Gs^Fds, Gs^Fds, Gs^Fds, Gll^Fp, Gs^Fds, Gll^Fp, Gs^Fds, Gs^Fds, Gll^Fp, Gg^Ve, Gg, Gs^Fds, Gs^Fds, Gg, Gg, Gs^Fds, Gs^Fds, Gs^Fds, Gs^Fds, Gg, Gs^Fds, Gs^Fds, Gll^Fp, Gs^Fds, Gg, Gs^Fds, Gll^Fp, Gs^Fds, Gs^Fds, Gg, Gll^Fp, Gll^Fp, Gg
Gg, Gg, Gg, Gs^Fds, Gs^Fds, Gs^Fds, Gs^Fds, Gs^Fds, Gs^Fds, Gs^Fds, Gs^Fds, Gg, Gg, Gg, Gg, Gg, Gg, Gs^Fds, Gs^Fds, Gs^Fds, Gs^Fds, Gs^Fds, Gs^Fds, Gll^Fp, Gll^Fp, Gs^Fds, Gll^Fp, Gll^Fp, Gll^Fp, Gll^Fp, Gll^Fp, Gs^Fds, Gs^Fds, Gs^Fds, Gll^Fp, Gll^Fp, Gs^Fds, Gg, Gs^Fds, Gs^Fds, Gg, Gll^Fp, Gll^Fp, Gll^Fp, Gll^Fp, Gll^Fp, Gs^Fds
