Ce, Ce, Ce, Ce, Ce, Ce, Ce, Ce, Ce, Ce, Mm, Mm, Mm, Mm, Mm, Mm, Mm, Mm, Ce, Ce, Ce, Ce, Ce, Ce, Ce, Hh, Hh, Mm, Mm, Mm, Mm, Mm, Mm, Mm, Mm, Ce, Ce, Ce, Ce, Ce, Ce, Ce, Ce, Ce, Ce
Ce, Ce, Ce, Ce, Ce, Ce, Ce, Ce, Ce, Ce, Ce, Mm, Mm, Mm, Hh, Mm, Mm, Mm, Ce, Ce, Ce, Ce, Ce, Ce, Ce, Ce, Ce, Mm, Mm, Mm, Hh, Hh, Hh, Mm, Mm, Ce, Ce, Ce, Ce, Ce, Ce, Ce, Ce, Ce, Ce
Ce, Ce, Ce, Ce, Ce, Ce, 6 Ke, Ce, Ce, Ce, Ce, Mm, Mm, Hh, Mm, Mm, Mm, Mm, Ce, Ce, Ce, 7 Ke, Ce, Ce, Ce, Ce, Ce, Mm, Mm, Mm, Mm, Mm, Hh, Mm, Mm, Ce, Ce, Ce, Ce, Ce, 5 Ke, Ce, Ce, Ce, Ce
Mm, Ce, Ce, Ce, Ce, Ce, Ce, Ce, Ce, Ce, Ce, Ce, Mm, Hh, Mm, Mm, Mm, Mm, Ce, Ce, Ce, Ce, Ce, Ce, Ce, Ce, Ce, Mm, Mm, Mm, Hh, Hh, Hh, Hh, Mm, Ce, Ce, Ce, Ce, Ce, Ce, Ce, Ce, Ce, Ce
Mm, Mm, Mm, Ce, Ce, Ce, Ce, Ce, Ce, Ce, Ce, Mm, Mm, Mm, Mm, Mm, Hh, Mm, Mm, Ce, Ce, Ce, Ce, Ce, Ce, Ce, Mm, Mm, Mm, Hh, Mm, Mm, Hh, Mm, Mm, Mm, Mm, Ce, Ce, Ce, Ce, Ce, Ce, Ce, Mm
Hh, Hh, Mm, Mm, Mm, Ce, Ce, Ce, Ce, Ce, Mm, Mm, Mm, Hh, Mm, Mm, Mm, Hh, Mm, Mm, Mm, Ce, Mm, Mm, Mm, Mm, Mm, Mm, Hh, Hh, Mm, Mm, Hh, Mm, Mm, Mm, Mm, Mm, Mm, Ce, Mm, Ce, Mm, Mm, Hh
Mm, Hh, Hh, Mm, Mm, Mm, Mm, Mm, Mm, Mm, Mm, Mm, Mm, Hh, Hh, Mm, Mm, Hh, Hh, Mm, Mm, Mm, Mm, Mm, Hh, Mm, Mm, Mm, Hh, Mm, Mm, Hh, Hh, Mm, Mm, Mm, Mm, Mm, Mm, Mm, Hh, Mm, Mm, Mm, Hh
Mm, Mm, Hh, Mm, Mm, Mm, Mm, Mm, Mm, Mm, Hh, Mm, Mm, Mm, Mm, Hh, Hh, Mm, Mm, Mm, Mm, Mm, Mm, Mm, Hh, Hh, Hh, Hh, Mm, Mm, Mm, Mm, Mm, Mm, Mm, Mm, Mm, Hh, Mm, Hh, Hh, Hh, Hh, Mm, Hh
Mm, Mm, Mm, Mm, Hh, Hh, Hh, Mm, Hh, Hh, Hh, Hh, Hh, Mm, Mm, Mm, Mm, Hh, Mm, Mm, Mm, Mm, Mm, Mm, Mm, Mm, Mm, Hh, Hh, Mm, Mm, Mm, Mm, Mm, Hh, Hh, Mm, Mm, Mm, Mm, Hh, Hh, Hh, Hh, Hh
Mm, Mm, Hh, Hh, Mm, Hh, Mm, Hh, Hh, Hh, Hh, Hh, Hh, Hh, Hh, Mm, Mm, Hh, Mm, Mm, Mm, Mm, Mm, Mm, Mm, Mm, Mm, Mm, Mm, Mm, Mm, Mm, Mm, Hh, Hh, Mm, Mm, Hh, Mm, Mm, Mm, Hh, Hh, Hh, Hh
Mm, Hh, Mm, Mm, Hh, Mm, Hh, Mm, Mm, Mm, Mm, Hh, Mm, Hh, Hh, Mm, Hh, Mm, Hh, Mm, Mm, Mm, Mm, Mm, Hh, Mm, Hh, Mm, Mm, Mm, Mm, Mm, Mm, Hh, Mm, Mm, Hh, Hh, Mm, Mm, Mm, Mm, Mm, Mm, Mm
Mm, Hh, Mm, Hh, Hh, Hh, Hh, Hh, Co, Hh, Hh, Mm, Hh, Mm, Mm, Hh, Mm, Hh, Mm, Mm, Hh, Hh, Mm, Hh, Mm, Mm, Mm, Mm, Mm, Mm, Mm, Mm, Mm, Mm, Hh, Hh, Hh, Hh, Co, Co, Co, Mm, Mm, Mm, Hh
Mm, Hh, Mm, Hh, Hh, Hh, Co, Co, Co, Co, Co, Hh, Hh, Mm, Hh, Mm, Mm, Hh, Mm, Mm, Mm, Mm, Mm, Mm, Mm, Mm, Mm, Mm, Mm, Mm, Mm, Hh, Hh, Mm, Mm, Hh, Co, Co, Co, Co, Co, Co, Co, Mm, Hh
Mm, Hh, Mm, Mm, Hh, Hh, Co, Co, Co, Co, Co, Co, Hh, Hh, Mm, Hh, Mm, Mm, Mm, Mm, Hh, Mm, Hh, Hh, Hh, Hh, Co, Mm, Hh, Mm, Mm, Mm, Mm, Mm, Hh, Hh, Co, Co, Co, Co, Co, Co, Co, Co, Hh
Mm, Mm, Mm, Mm, Hh, Hh, Co, Co, Co, Co, Co, Co, Hh, Hh, Hh, Mm, Hh, Hh, Hh, Hh, Mm, Mm, Hh, Hh, Co, Co, Co, Co, Co, Hh, Mm, Mm, Mm, Mm, Hh, Hh, Co, Co, Co, Co, Co, Co, Co, Co, Hh
Mm, Hh, Mm, Mm, Hh, Hh, Co, Co, Co, Co, Co, Co, Co, Hh, Hh, Hh, Hh, Hh, Hh, Hh, Mm, Hh, Co, Co, Co, Co, Co, Co, Co, Co, Co, Mm, Hh, Mm, Mm, Hh, Co, Co, Co, Co, Co, Co, Co, Co, Hh
Mm, Mm, Mm, Mm, Mm, Hh, Co, Co, Co, Co, Co, Co, Co, Hh, Hh, Hh, Mm, Hh, Mm, Mm, Hh, Hh, Co, Co, Co, Co, Co, Co, Co, Co, Co, Hh, Hh, Mm, Mm, Hh, Hh, Co, Co, Co, Co, Co, Co, Co, Mm
Mm, Hh, Hh, Mm, Mm, Hh, Co, Co, Co, Co, Co, Co, Co, Hh, Hh, Hh, Mm, Mm, Mm, Mm, Hh, Hh, Co, Co, Co, Co, Co, Co, Co, Co, Co, Hh, Mm, Mm, Hh, Hh, Hh, Co, Co, Co, Co, Co, Co, Co, Mm
Mm, Hh, Mm, Mm, Mm, Hh, Co, Co, Co, Co, Co, Co, Co, Hh, Hh, Hh, Mm, Mm, Mm, Hh, Hh, Hh, Co, Co, Co, Co, Co, Co, Co, Co, Co, Hh, Mm, Mm, Mm, Mm, Hh, Co, Co, Co, 8 Ko, Co, Co, Co, Mm
Mm, Mm, Hh, Mm, Mm, Hh, Co, Co, Co, 9 Ko, Co, Co, Co, Mm, Mm, Mm, Mm, Mm, Mm, Mm, Hh, Hh, Co, Co, Co, Co, 2 Ko, Co, Co, Co, Co, Hh, Hh, Hh, Mm, Mm, Hh, Co, Co, Co, Co, Co, Co, Co, Mm
Mm, Mm, Hh, Hh, Hh, Hh, Co, Co, Co, Co, Co, Co, Co, Mm, Hh, Mm, Mm, Mm, Mm, Hh, Hh, Hh, Co, Co, Co, Co, Co, Co, Co, Co, Co, Hh, Hh, Mm, Hh, Hh, Hh, Co, Co, Co, Co, Co, Co, Co, Mm
Mm, Mm, Mm, Hh, Hh, Hh, Co, Co, Co, Co, Co, Co, Co, Hh, Hh, Mm, Hh, Hh, Mm, Hh, Hh, Hh, Co, Co, Co, Co, Co, Co, Co, Co, Co, Hh, Mm, Mm, Hh, Hh, Hh, Co, Co, Co, Co, Co, Co, Co, Mm
Mm, Hh, Hh, Mm, Hh, Hh, Co, Co, Co, Co, Co, Co, Co, Co, Hh, Hh, Mm, Hh, Mm, Mm, Hh, Hh, Co, Co, Co, Co, Co, Co, Co, Co, Co, Hh, Mm, Hh, Hh, Hh, Hh, Co, Co, Co, Co, Co, Co, Mm, Mm
Mm, Hh, Mm, Mm, Hh, Hh, Co, Co, Co, Co, Co, Co, Co, Co, Hh, Mm, Mm, Mm, Mm, Mm, Mm, Hh, Co, Co, Co, Co, Co, Co, Co, Co, Co, Hh, Hh, Mm, Mm, Hh, Hh, Co, Co, Co, Co, Co, Co, Mm, Mm
Mm, Hh, Hh, Mm, Hh, Hh, Co, Co, Co, Co, Co, Co, Co, Co, Hh, Mm, Mm, Mm, Hh, Mm, Hh, Hh, Hh, Co, Co, Co, Co, Co, Co, Co, Hh, Hh, Mm, Hh, Mm, Hh, Hh, Co, Co, Co, Co, Co, Co, Mm, Mm
Mm, Hh, Hh, Mm, Mm, Hh, Co, Co, Co, Co, Co, Co, Co, Hh, Hh, Mm, Hh, Hh, Hh, Hh, Mm, Hh, Mm, Hh, Hh, Co, Co, Co, Hh, Hh, Hh, Hh, Mm, Mm, Mm, Mm, Hh, Co, Co, Co, Co, Co, Mm, Mm, Mm
Mm, Hh, Hh, Hh, Mm, Hh, Hh, Co, Co, Co, Co, Co, Mm, Mm, Hh, Hh, Hh, Mm, Mm, Mm, Hh, Mm, Hh, Mm, Hh, Hh, Mm, Hh, Mm, Hh, Hh, Mm, Hh, Mm, Mm, Mm, Mm, Hh, Hh, Co, Mm, Mm, Mm, Mm, Mm
Mm, Mm, Hh, Hh, Hh, Mm, Hh, Hh, Mm, Co, Co, Hh, Mm, Hh, Hh, Hh, Hh, Mm, Hh, Mm, Mm, Mm, Hh, Mm, Mm, Mm, Hh, Mm, Hh, Mm, Mm, Mm, Hh, Mm, Mm, Mm, Hh, Hh, Mm, Hh, Mm, Mm, Mm, Mm, Mm
Mm, Mm, Hh, Hh, Hh, Mm, Hh, Hh, Mm, Mm, Mm, Hh, Hh, Mm, Mm, Mm, Mm, Mm, Hh, Mm, Hh, Mm, Hh, Hh, Mm, Mm, Hh, Hh, Hh, Hh, Mm, Mm, Hh, Mm, Mm, Mm, Hh, Mm, Mm, Mm, Mm, Mm, Mm, Mm, Mm
Mm, Mm, Hh, Mm, Mm, Mm, Hh, Hh, Mm, Mm, Mm, Mm, Hh, Hh, Mm, Mm, Mm, Hh, Hh, Hh, Co, Hh, Hh, Hh, Mm, Mm, Mm, Mm, Mm, Mm, Hh, Hh, Mm, Mm, Mm, Mm, Mm, Mm, Hh, Mm, Mm, Mm, Mm, Mm, Mm
Mm, Hh, Mm, Mm, Hh, Hh, Hh, Hh, Ce, Mm, Mm, Mm, Mm, Mm, Hh, Hh, Hh, Mm, Hh, Hh, Hh, Hh, Mm, Mm, Hh, Hh, Hh, Hh, Hh, Hh, Hh, Hh, Mm, Hh, Mm, Hh, Mm, Hh, Ce, Mm, Ce, Mm, Mm, Mm, Mm
Mm, Hh, Mm, Hh, Hh, Hh, Ce, Ce, Ce, Ce, Ce, Hh, Hh, Hh, Hh, Mm, Hh, Mm, Mm, Hh, Hh, Hh, Hh, Hh, Ce, Hh, Hh, Hh, Hh, Hh, Mm, Mm, Mm, Mm, Mm, Mm, Hh, Hh, Ce, Ce, Ce, Ce, Ce, Mm, Mm
Mm, Mm, Mm, Mm, Hh, Hh, Ce, Ce, Ce, Ce, Ce, Ce, Ce, Hh, Mm, Mm, Mm, Hh, Mm, Hh, Ce, Ce, Ce, Ce, Ce, Ce, Mm, Hh, Hh, Hh, Mm, Hh, Mm, Mm, Hh, Hh, Ce, Ce, Ce, Ce, Ce, Ce, Ce, Ce, Ce
Mm, Mm, Mm, Mm, Mm, Ce, Ce, Ce, Ce, Ce, Ce, Ce, Ce, Ce, Mm, Mm, Mm, Mm, Ce, Ce, Ce, Ce, Ce, Ce, Ce, Ce, Ce, Mm, Mm, Mm, Mm, Mm, Mm, Mm, Ce, Ce, Ce, Ce, Ce, Ce, Ce, Ce, Ce, Ce, Ce
Mm, Mm, Mm, Mm, Mm, Ce, Ce, Ce, Ce, 1 Ke, Ce, Ce, Ce, Ce, Hh, Hh, Hh, Ce, Ce, Ce, Ce, Ce, Ce, Ce, Ce, Ce, Ce, Ce, Mm, Mm, Hh, Hh, Mm, Hh, Ce, Ce, Ce, Ce, Ce, Ce, Ce, 4 Ke, Ce, Ce, Ce
Mm, Mm, Mm, Mm, Mm, Ce, Ce, Ce, Ce, Ce, Ce, Ce, Ce, Ce, Hh, Hh, Hh, Ce, Ce, Ce, Ce, Ce, Ce, 3 Ke, Ce, Ce, Ce, Ce, Mm, Hh, Hh, Mm, Mm, Hh, Ce, Ce, Ce, Ce, Ce, Ce, Ce, Ce, Ce, Ce, Ce
Mm, Mm, Mm, Mm, Mm, Mm, Mm, Ce, Ce, Ce, Ce, Ce, Ce, Ce, Mm, Hh, Hh, Ce, Ce, Ce, Ce, Ce, Ce, Ce, Ce, Ce, Ce, Ce, Mm, Mm, Mm, Mm, Mm, Mm, Mm, Ce, Ce, Ce, Ce, Ce, Ce, Ce, Ce, Ce, Ce
Mm, Mm, Mm, Mm, Mm, Mm, Mm, Mm, Mm, Ce, Ce, Ce, Mm, Mm, Mm, Hh, Hh, Ce, Ce, Ce, Ce, Ce, Ce, Ce, Ce, Ce, Ce, Ce, Mm, Mm, Mm, Mm, Mm, Mm, Mm, Mm, Mm, Mm, Gg, Ce, Mm, Ce, Ce, Ce, Gg
