Mm, Mm, Hh, Hh, Hh, Hh, Hh, Hh, Hh, Hh, Mm, Mm, Mm, Mm, Mm, Hh, Hh, Hh, Hh, Hh, Mm, Mm, Mm, Mm, Mm, Mm, Hh, Hh, Hh, Hh, Hh, Hh, Hh, Mm, Mm, Hh, Hh, Hh, Hh, Hh, Hh, Hh, Hh, Hh, Mm, Mm
Hh, Hh, Ce, Ce, Ce, Hh, Hh, Hh^Vhh, Hh, Mm, Hh, Mm, Hh, Hh, Ce, Hh, Hh, Hh, Hh, Hh, Hh^Vhh, Hh, Hh, Mm, Hh, Hh, Ce, Ce, Ce, Hh, Hh, Gs^Vl, Hh, Mm, Mm, Hh, Gs^Vc, Hh, Hh, Hh, Ce, Ce, Ce, Ce, Ce, Mm
Hh, Ce, Ce, Ce, Ce, Ce, Ce, Hh, Hh, Gs^Vl, Hh, Hh, Ce, Ce, Ce, Ce, Ce, Hh, Hh, Hh, Hh, Hh, Hh, Hh, Ce, Ce, Ce, Ce, Ce, Ce, Ce, Hh, Hh, Hh, Hh, Mm, Hh, Hh, Hh, Ce, Ce, Ce, Ce, Ce, Ce, Hh
Hh, Ce, Ce, Ce, Ce, 6 Ke, Ce, Hh, Hh, Hh, Hh, Ce, Ce, Ce, 5 Ke, Ce, Ce, Ce, Hh, Hh, Hh, Hh, Hh, Hh, Ce, Ce, Ce, Ce, Ce, Ce, Ce, Hh, Hh, Hh^Vhh, Hh, Hh, Hh, Hh, Hh, Ce, 4 Ke, Ce, Ce, Ce, Ce, Hh
Hh, Ce, Ce, Ce, Ce, Ce, Gg, Hh, Gg^Es, Hh, Gg, Ce, Ce, Ce, Ce, Ce, Ce, Ce, Gg, Gg, Gg, Gg, Gg, Gg, Ce, Ce, Ce, 1 Ke, Ce, Ce, Ce, Gg, Gg, Gg, Gg, Gg, Gg, Hh, Gg, Ce, Ce, Ce, Ce, Ce, Ce, Hh
Hh, Ce, Ce, Ce, Gg, Gg, Gg, Gg, Gg, Gg, Gg, Ce, Ce, Ce, Ce, Ce, Ce, Ce, Gg, Gg, Gg, Gg, Gg, Gg, Ce, Ce, Ce, Ce, Ce, Ce, Ce, Gg, Gg, Gg, Gg^Gvs, Gg, Gg, Gg, Gg, Gg, Gg, Ce, Ce, Ce, Ce, Hh
Hh, Hh, Hh, Gg, Gg, Gg, Gg^Gvs, Gg^Gvs, Gg^Gvs, Gg, Gg, Gg, Gg, Ce, Gg, Ce, Gg, Gg, Gg, Gg, Gg, Gg, Gg, Gg, Gg, Ce, Gg, Ce, Ce, Ce, Gg, Gg, Gg, Gg^Gvs, Gg^Gvs, Gg^Gvs, Gg^Gvs, Gg, Gg, Gg, Gg, Hh, Hh, Hh, Hh, Hh
Mm, Hh, Hh, Gg, Gg, Gg^Gvs, Gg^Gvs, Gg^Gvs, Gg^Gvs, Gg^Gvs, Gg^Gvs, Gg, Gg, Gg, Gg, Gg, Gg, Gg, Gg, Gg, Gg, Gg, Gg, Gg, Gg, Gg, Gg, Gg, Gg, Gg, Gg, Gg, Gg, Gg^Gvs, Gg^Gvs, Gg^Gvs, Gg^Gvs, Gg^Gvs, Gg, Gg, Gg, Hh, Hh, Hh, Hh^Vhh, Hh
Mm, Gs^Vc, Hh, Gg, Gg, Gg^Gvs, Gg^Gvs, Gg^Gvs, Gg^Gvs, Gg^Gvs, Gg^Gvs, Gg, Gg, Gg, Gg, Gg, Gg, Gg^Gvs, Gg^Gvs, Gg^Gvs, Gg, Gg, Gg^Es, Gg^Es, Gg^Es, Gg^Es, Gg^Es, Gg, Gg, Gg, Gg, Gg, Gg, Gg^Gvs, Gg^Gvs, Gg^Gvs, Gg^Gvs, Gg^Gvs, Gg, Gg, Gg, Hh, Gs^Vc, Hh, Hh, Hh
Mm, Mm, Hh, Hh, Gg, Gg, Gg, Gg^Gvs, Gg^Gvs, Gg^Gvs, Gg^Gvs, Gg^Gvs, Gg, Gg, Gg, Gg, Gg, Gg^Gvs, Gs^Vc, Gg^Gvs, Gg^Gvs, Gg, Hh, Hh, Hh, Hh, Hh, Gg, Gg, Gg, Gs^Vh, Gg, Gg, Gg, Gg, Gg^Gvs, Gs^Vc, Gg^Gvs, Gg, Gg, Gg, Hh, Hh, Hh, Mm, Mm
Hh, Hh^Vhh, Hh, Hh, Gg, Gg, Gg, Gs^Vc, Gg, Gg, Gg, Gg, Gg, Gg, Gg^Gvs, Gg^Gvs, Gg^Gvs, Gg^Gvs, Gg^Gvs, Gg^Gvs, Gg^Gvs, Gg, Gg, Hh, Hh, Hh, Hh, Gg, Gg^Gvs, Gg, Gg, Gg, Gg, Hh, Hh, Gg, Gg^Es, Gg, Gg^Es, Gg, Gg^Es, Hh, Hh, Hh, Hh, Mm
Hh, Hh, Hh, Hh, Gg, Gg, Gg, Gg, Gg^Es, Gg, Gg, Gg, Gg, Gg, Gg^Gvs, Gg^Vwm, Gg^Gvs, Gg, Gg, Gg^Gvs, Gg, Gg, Gg, Gg, Gg, Gg, Gg, Gg^Gvs, Gg^Gvs, Gg^Gvs, Gg^Gvs, Gg, Gg, Hh, Gg, Hh, Hh^Es, Gg^Es, Gg^Es, Gg^Es, Gg^Es, Hh, Hh, Gs^Vl, Hh, Hh
Hh, Ce, Hh, Ce, Gg, Gg, Gg, Gg, Gg, Gg, Gg, Gg, Gg^Gvs, Gg, Gg^Gvs, Gg^Gvs, Gg^Gvs, Gg^Gvs, Gg^Gvs, Gg^Gvs, Gg^Es, Gg, Gg, Gg, Gs^Vh, Gg, Gg, Gg, Gg^Gvs, Gg^Gvs, Gs^Vc, Gg^Gvs, Gg^Gvs, Gg, Gg^Vwm, Gg, Gg, Gg^Es, Gg, Gg, Gg, Hh, Ce, Hh, Ce, Hh
Hh, Ce, Ce, Ce, Ce, Gg, Gg, Gg, Gg, Gg, Gg, Gg, Gg, Gg^Gvs, Gg, Gg, Gg, Gg, Gg^Gvs, Gg^Gvs, Gg^Es, Gg, Gg, Gg, Gg, Gg, Gg^Es, Gg^Es, Gg^Gvs, Gg^Gvs, Gg^Gvs, Gs^Vc, Gg^Gvs, Gg, Gg, Gg, Gg, Gg, Gg, Gg, Gg, Hh, Ce, Hh, Ce, Hh
Hh, Ce, Ce, Ce, 7 Ke, Ce, Gg, Gg, Gg, Gg, Gg, Hh, Hh, Gg, Gg, Gg, Gg, Gg, Gg, Gg^Es, Gg^Es, Gg, Gg, Gg, Gg, Gg, Hh, Gg^Es, Gg^Es, Gg, Gg, Gg^Gvs, Gg^Gvs, Gg^Gvs, Gg, Gg, Gg, Gg, Gg, Gg, Ce, Ce, Ce, Ce, Ce, Hh
Hh, Ce, Ce, Ce, Ce, Ce, Gg, Gg, Gg, Gg, Hh, Hh, Gg, Gg, Gg, Gs^Vh, Gg, Gg, Gg, Gg, Gg, Gg, Gg, Gg, Gg, Gg, Gg, Hh, Hh, Hh, Hh, Gg, Gg, Gg^Gvs, Gg^Gvs, Gg, Gg, Gg, Gg, Gg, Ce, 2 Ke, Ce, Ce, Ce, Hh
Hh, Ce, Hh, Ce, Hh, Gg, Gg, Gg, Hh, Hh, Gg^Es, Hh, Gg, Gg, Gg, Gg, Gg, Gg, Gg, Gg, Gg, Gg, Gg, Gg, Gg, Gg, Gg, Gg, Gg, Gg, Gg, Hh, Hh, Gg, Gg, Gg, Gg, Gg, Gg, Gg, Gg, Ce, Ce, Ce, Ce, Hh
Hh, Ce, Hh, Ce, Hh, Gg, Gg, Hh, Hh, Gg^Vwm, Gg, Gg, Gg, Gd^Vo, Gg, Gg, Gg, Gg, Gg, Gg, Gg, Co, Co, Co, Gg, Gg, Gg, Gg, Gg, Gg, Gg, Hh, Gg^Es, Gg, Gg, Gg, Gg, Gg, Gg, Gg, Hh, Hh, Ce, Hh, Ce, Hh
Hh, Hh, Hh^Vhh, Hh, Hh, Gg, Gg, Hh, Gg, Gg, Gg, Gg, Gg^Es, Gg^Es, Gg, Gg, Gg, Gg, Co, Co, Gg, Gg, Gg, Gg, Gg, Co, Co, Gg, Gg, Gg, Gd^Vo, Gg^Es, Gg^Es, Gg, Gg, Gg, Gg, Gg, Gg^Vwm, Gg, Gg, Hh, Hh, Hh, Hh, Hh
Mm, Hh, Hh, Hh, Gg, Gg, Gg, Gg, Gg, Gg, Gg^Es, Gg^Es, Gd^Vo, Gg, Gg, Gg, Co, Co, Gg, Gg, Gg, Gg, Gg, Gg, Gg, Gg, Gg, Co, Co, Gg, Gg, Gg, Gg^Es, Gg, Gg^Es, Gg^Es, Gg, Gg, Gg, Gg, Gg, Gg, Hh, Hh^Vhh, Hh, Hh
Mm, Mm, Gg, Gg, Gg, Gg, Gg, Gg, Gg, Gg, Gg, Gg, Gg, Gg, Gg, Co, Gg, Gg, Gg, Gg, Co, Co, Co, Co, Co, Gg, Gg, Gg, Co, Gg, Gg, Gg, Gg, Gg^Es, Gg, Gg, Gg, Gg, Gg, Gg, Gg, Gg, Gg, Hh, Mm, Mm
Gg, Gg, Gg, Gg, Gg, Gg, Gg, Gg, Gg, Gg, Gg, Gg, Gg, Gg, Gg, Co, Gg, Gg, Co, Co, Co, Co, Co, Co, Co, Co, Gg, Gg, Co, Gg, Gg, Gg, Gd^Vo, Gg, Gg, Gg, Gg, Gg, Gg, Gg, Gg, Gg, Gg, Gg, Gg, Mm
Gg, Gg, Gg^Ecf, Gg, Gg, Gg, Co, Gg, Gg, Gg, Gg^Ecf, Gg, Gg, Gg, Gg, Co, Gg, Gg, Co, Co, Co, Co, 3 Ko, Co, Co, Co, Gg, Gg, Co, Gg, Gg, Gg, Gg, Gg, Gg, Gg^Ecf, Gg, Gg, Co, Co, Co, Gg, Gg, Gg^Ecf, Gg, Gg
Gg, Gg, Gg, Gg, Co, Co, Co, Co, Co, Gg, Gg, Gg, Gg, Gg, Gg, Co, Gg, Gg, Co, Co, Co, Co, Co, Co, Co, Co, Gg, Gg, Co, Gg, Gg, Gg, Gg, Gg, Gg, Gg, Gg, Co, Co, Co, Co, Co, Gg, Gg, Gg, Gg
Gg, Gg, Gg^Ecf, Gg, Co, Co, 8 Ko, Co, Co, Gg, Gg^Ecf, Gg, Gg, Gg, Gg, Gg, Gg, Gg, Co, Co, Co, Co, Co, Co, Co, Co, Gg, Gg, Gg, Gg, Gg, Gg, Gg, Gg, Gg, Gg^Ecf, Gg, Co, Co, 9 Ko, Co, Co, Gg, Gg^Ecf, Gg, Gg
Gg, Gg, Gg, Gg, Co, Co, Co, Co, Co, Gg, Gg, Gg, Gg, Gg, Gg, Co, Gg, Gg, Co, Co, Co, Co, Co, Co, Co, Co, Gg, Gg, Co, Gg, Gg, Gg, Gg, Gg, Gg, Gg, Gg, Co, Co, Co, Co, Co, Gg, Gg, Gg, Gg
Gg, Gg, Gg^Ecf, Gg, Gg, Co, Gg, Co, Gg, Gg, Gg^Ecf, Gg, Gg, Gg, Gg, Co, Gg, Gg, Gg, Co, Co, Co, Co, Co, Co, Co, Gg, Gg, Co, Gg, Gg, Gg, Gg, Gg, Gg, Gg^Ecf, Gg, Gg, Gg, Gg, Gg, Gg, Gg, Gg^Ecf, Gg, Gg
Gg, Gg, Gg, Gg, Gg, Gg, Gg, Gg, Gg, Gg, Gg, Gg, Gg, Gg, Gg, Co, Co, Gg, Gg, Gg, Gg, Co, Gg, Co, Gg, Gg, Gg, Gg, Co, Gg, Gg, Gd^Vo, Gg, Gg, Gg, Gg, Gg, Gg, Gg, Gg, Gg, Gg, Gg, Gg, Gg, Gg
Gg, Gg, Gg, Gg, Gg, Gg, Gg, Gg, Gll^Fp, Gll^Fp, Gll^Fp, Gg, Gg, Gg, Gg, Gg, Gg, Co, Co, Gg, Gg, Gg, Gg, Gg, Gg, Gg, Co, Co, Gg, Gg, Gg, Gg, Gg, Gg, Gg^Gvs, Gg^Gvs, Gg^Gvs, Gg^Gvs, Gg, Gg, Gg, Gg, Gg, Gg, Gg, Gg
Gg, Gd^Vo, Gg, Gg, Gg, Gg, Gll^Fp, Gll^Fp, Gll^Fp, Gll^Fp, Gll^Fp, Gll^Fp, Gll^Fp, Gg, Gg, Gg, Gg, Gg, Gg, Co, Gg, Gg, Co, Gg, Gg, Co, Gg, Gg, Gg, Gg, Gg, Gg, Gg, Gg^Gvs, Gg, Gg, Gg^Gvs, Gg^Gvs, Gg^Gvs, Gg, Gg, Gg, Gg, Gg, Gg, Gg
Gll^Fp, Gll^Fp, Gg, Gg, Gll^Fp, Gll^Fp, Gll^Fp, Gll^Fp, Gll^Fp, Gll^Fp, Gll^Fp, Gll^Fp, Gll^Fp, Gd^Vo, Gd^Vo, Gg, Gg, Gg, Gg, Gg, Gg, Co, Gg, Co, Gg, Gg, Gg, Gg, Gd^Vo, Gg, Gg, Gg, Gg^Gvs, Gg^Gvs, Gg, Gg, Gg^Gvs, Gg, Gg^Gvs, Gg, Gg, Gg, Gg, Gg, Gll^Fp, Gg
Gll^Fp, Gll^Fp, Gg, Gg, Gll^Fp, Gg^Fet, Gll^Fp, Gll^Fp, Gll^Fp, Gg^Fet, Gll^Fp, Gll^Fp, Gll^Fp, Gll^Fp, Gll^Fp, Gg, Gll^Fp, Gg, Gg, Gg, Gg, Gg, Gg, Gg, Gg, Gg, Gg, Gg, Gg, Gg, Gg, Gg, Gg^Gvs, Gg, Gg^Gvs, Gg, Gg^Gvs, Gg^Gvs, Gg, Gg, Gg, Gg, Gll^Fp, Gg, Gll^Fp, Gg
Gg, Gll^Fp, Gg, Gd^Vo, Gg, Gll^Fp, Gll^Fp, Gll^Fp, Gll^Fp, Gll^Fp, Gll^Fp, Gll^Fp, Gll^Fp, Gll^Fp, Gll^Fp, Gll^Fp, Gll^Fp, Gd^Vo, Gg, Gg, Gg, Gg, Gll^Fp, Gg, Gg, Gg, Gg, Gg, Gll^Fp, Gg, Gll^Fp, Gg, Gg^Gvs, Gg^Gvs, Gg^Fet, Gg^Gvs, Gg^Gvs, Gg^Gvs, Gg, Gg, Gll^Fp, Gll^Fp, Gd^Vo, Gd^Vo, Gll^Fp, Gg
Gll^Fp, Gll^Fp, Gg, Gg, Gg, Gll^Fp, Gll^Fp, Gg^Fet, Gll^Fp, Gll^Fp, Gll^Fp, Gll^Fp, Gll^Fp, Gll^Fp, Gll^Fp, Gll^Fp, Gll^Fp, Gll^Fp, Gll^Fp, Gg, Gll^Fp, Gll^Fp, Gd^Vo, Gll^Fp, Gll^Fp, Gll^Fp, Gll^Fp, Gll^Fp, Gll^Fp, Gll^Fp, Gll^Fp, Gll^Fp, Gll^Fp, Gg^Gvs, Gg^Gvs, Gg^Gvs, Gg, Gg, Gg, Gg, Gll^Fp, Gll^Fp, Gll^Fp, Gd^Vo, Gll^Fp, Gg
Gll^Fp, Gg, Gg, Gg, Gg, Gg, Gg, Gll^Fp, Gll^Fp, Gll^Fp, Gll^Fp, Gll^Fp, Gg, Gll^Fp, Gll^Fp, Gll^Fp, Gll^Fp, Gll^Fp, Gll^Fp, Gll^Fp, Gll^Fp, Gll^Fp, Gg, Gll^Fp, Gg, Gll^Fp, Gll^Fp, Gg, Gll^Fp, Gll^Fp, Gll^Fp, Gll^Fp, Gg, Gg, Gg, Gg, Gg, Gg, Gg, Gg, Gg, Gg, Gg, Gll^Fp, Gg, Gg
