Mm, Mm, Mm, Mm, Hh, Hh, Hh, Hh, Mm, Hh, Hh, Hh, Hh, Hh, Hh, Mm, Mm, Mm, Mm
Mm, Mm, Hh, Hh, Hh, Hh, Hh, Hh, Hh, Mm, Mm, Hh, Hh, Hh, Hh, Hh, Hh, Hh, Mm
Hh, Hh, Hh, Hh, Rb^Ecf, Hh, Rb^Es, Hh, Rb, Rb^Ecf, Rb, Mm, Mm, Hh, Mm, Hh, Hh, Hh, Mm
Hh, Hh, Hh, Hh, Rb^Es, Rb, Rb^Es, Rb, Rb, Rb, Rb^Es, Rb^Es, Rb^Es, Mm, Mm, Mm, Mm, Hh, Mm
Hh, Hh, Hh, Hh, Rb, Rb, Rb^Es, Rb^Es, Rb, Rb, Cf, Rb, Rb, Rb, Rb^Ecf, Rb^Es, Rb^Ecf, Mm, Mm
Hh, Hh, Hh, Hh, Rb^Es, Rb, Rb, Rb, Cf, Cf, 4 Cf, Cf, Cf, Rb, Rb^Es, Rb, Hh, Hh, Hh
Hh, Hh, Hh, Hh, Rb^Ecf, Rb, Cf, Cf, Cf, Cf, Cf, Cf, Cf, Cf, Cf, Hh, Hh, Hh, Hh
Mm, Mm, Hh, Hh, Rb, Rb, Cf, 3 Cf, Cf, Cf, Cf, Cf, Cf, 6 Cf, Cf, Cf, Cf, Hh, Hh
Mm, Mm, Hh, Hh, Rb, Rb, Cf, Cf, Cf, Cf, Cf, 1 Cf, Cf, Cf, Cf, Cf, Cf, Cf, Hh
Mm, Mm, Hh, Hh, Rb^Es, Rb, Rb, Cf, Cf, Cf, Cf, Cf, Cf, Cf, Cf, 2 Cf, Cf, Cf, Hh
Mm, Mm, Hh, Hh, Rb^Es, Rb, Rb^Es, Rb, Rb, Cf, Cf, Cf, 5 Cf, Cf, Cf, Cf, Hh, Hh, Hh
Mm, Mm, Hh, Hh, Rb^Ecf, Rb, Rb^Es, Rb, Rb^Es, Rb, Rb, Cf, Cf, Cf, Rb^Ecf, Hh, Hh, Hh, Hh
Hh, Mm, Mm, Hh, Mm, Rb^Es, Rb^Es, Rb, Rb, Rb^Ecf, Rb, Rb, Rb, Rb, Rb^Es, Hh, Hh, Hh, Hh
Hh, Mm, Mm, Mm, Hh, Mm, Mm, Mm, Mm, Mm, Mm, Rb^Es, Rb, Rb^Ecf, Rb^Es, Hh, Hh, Hh, Hh
Hh, Mm, Mm, Mm, Mm, Hh, Hh, Hh, Hh, Hh, Hh, Hh, Hh, Mm, Mm, Hh, Hh, Hh, Hh
Hh, Hh, Mm, Mm, Hh, Mm, Mm, Mm, Mm, Mm, Mm, Hh, Mm, Mm, Mm, Hh, Hh, Hh, Hh
Mm, Hh, Mm, Mm, Mm, Hh, Hh, Hh, Hh, Hh, Hh, Mm, Hh, Hh, Mm, Mm, Hh, Hh, Mm
Mm, Mm, Mm, Mm, Mm, Mm, Hh, Hh, Hh, Hh, Hh, Hh, Hh, Hh, Hh, Mm, Mm, Mm, Mm
Mm, Mm, Mm, Mm, Mm, Hh, Hh, Hh, Hh, Hh, Hh, Hh, Hh, Hh, Mm, Mm, Mm, Mm, Mm
