Xu, Xu, Xu, Xu, Xu, Xu, Xu, Xu, Xu, Xu, Xu, Xu, Xu, Xu, Xu, Xu, Xu, Xu, Xu, Xu, Xu, Xu, Xu, Xu, Xu, Xu, Xu, Xu, Xu, Xu, Xu, Xu, Xu, Xu, Xu, Xu, Xu, Xu, Xu, Xu, Xu, Xu, Xu, Xu, Xu, Xu, Xu
Xu, Xu, Xu, Xu, Xu, Xu, Xu, Xu, Xu, Xu, Xu, Xu, Xu, Xu, Xu, Xu, Xu, Xu, Xu, Xu, Xu, Xu, Xu, Xu, Xu, Xu, Xu, Xu, Xu, Xu, Xu, Xu, Xu, Xu, Xu, Xu, Xu, Xu, Xu, Xu, Xu, Xu, Xu, Xu, Xu, Xu, Xu
Xu, Xu, Xu, Xu, Xu, Xu, Xu, Xu, Xu, Xu, Xu, Xu, Xu, Xu, Xu, Xu, Xu, Xu, Xu, Xu, Xu, Xu, Xu, Xu, Xu, Xu, Xu, Xu, Xu, Xu, Xu, Xu, Xu, Xu, Xu, Xu, Xu, Xu, Xu, Xu, Xu, Xu, Xu, Xu, Xu, Xu, Xu
Xu, Xu, Xu, Xu, Xu, Xu, Xu, Xu, Xu, Xu, Xu, Xu, Xu, Xu, Xu, Xu, Xu, Xu, Xu, Xu, Xu, Xu, Xu, Xu, Xu, Xu, Xu, Xu, Xu, Xu, Xu, Xu, Xu, Xu, Xu, Xu, Xu, Xu, Xu, Xu, Xu, Xu, Xu, Xu, Xu, Xu, Xu
Xu, Xu, Xu, Xu, Xu, Xu, Xu, Xu, Xu, Xu, Xu, Xu, Xu, Xu, Xu, Xu, Xu, Xu, Xu, Xu, Xu, Xu, Xu, Xu, Xu, Xu, Xu, Xu, Xu, Xu, Xu, Xu, Xu, Xu, Xu, Xu, Xu, Xu, Xu, Xu, Xu, Xu, Xu, Xu, Xu, Xu, Xu
Xu, Xu, Xu, Xu, Xu, Xu, Xu, Xu, Xu, Xu, Xu, Xu, Xu, Xu, Xu, Xu, Xu, Xu, Xu, Xu, Xu, Xu, Xu, Xu, Xu, Xu, Xu, Xu, Xu, Xu, Xu, Xu, Xu, Xu, Xu, Xu, Xu, Xu, Xu, Xu, Xu, Xu, Xu, Xu, Xu, Xu, Xu
Xu, Xu, Xu, Xu, Xu, Xu, Xu, Xu, Xu, Xu, Xu, Xu, Xu, Xu, Xu, Xu, Xu, Xu, Xu, Xu, Xu, Xu, Xu, Xu, Xu, Xu, Xu, Xu, Xu, Xu, Xu, Xu, Xu, Xu, Xu, Xu, Xu, Xu, Xu, Xu, Xu, Xu, Xu, Xu, Xu, Xu, Xu
Xu, Xu, Xu, Xu, Xu, Xu, Xu, Xu, Xu, Xu, Xu, Xu, Xu, Xu, Xu, Xu, Xu, Xu, Xu, Xu, Xu, Xu, Xu, Xu, Xu, Xu, Xu, Xu, Xu, Xu, Xu, Xu, Xu, Xu, Xu, Xu, Xu, Xu, Xu, Xu, Xu, Xu, Xu, Xu, Xu, Xu, Xu
Xu, Xu, Xu, Xu, Xu, Xu, Xu, Xu, Xu, Xu, Xu, Xu, Xu, Xu, Xu, Xu, Xu, Xu, Xu, Xu, Qxu, Xu, Xu, Xu, Xu, Xu, Xu, Xu, Xu, Xu, Xu, Xu, Xu, Xu, Xu, Xu, Xu, Xu, Xu, Xu, Xu, Xu, Xu, Xu, Chr, Xu, Xu
Xu, Xu, Xu, Xu, Xu, Xu, Xu, Xu, Xu, Xu, Xu, Xu, Xu, Xu, Xu, Xu, Uu^Vu, Qxu, Qxu, Qxu, Qxu, Qxu, Uu, Uu^Vu, Uu, Xu, Xu, Xu, Xu, Xu, Xu, Xu, Xu, Xu, Xu, Xu, Xu, Xu, Xu, Xu, Uu, Chr, Chr, Chr, 4 Khr, Chr, Uu
Xu, Xu, Xu, Xu, Xu, Xu, Xu, Xu, Xu, Xu, Xu, Xu, Xu, Xu, Chr, Uu, Uu, Uu, Uu, Qxu, Uu, Uu, Uu, Uu, Uu, Uu, Uu, Xu, Uu^Vu, Xu, Xu, Xu, Xu, Xu, Xu, Xu, Qxu, Xu, Uu^Vu, Uu, Uu, Chr, Uu, Chr, Uh, Chr, Uh
Xu, Xu, Xu, Xu, Xu, Xu, Xu, Xu, Xu, Xu, Xu, Xu, Chr, Chr, Chr, Uu, Tb^Tf, Uu, Uu, Uu, Uu, Uu, Uu, Uu, Uh, Uh, Uh, Uhe, Uhe, Uu, Uu, Uu, Uu, Xu, Qxu, Qxu, Qxu, Uu, Uu, Uu, Uh, Uh, Uh, Uh, Uh, Uu, Uh
Uu, Xu, Uu, Xu, Uu, Xu, Uu, Xu, Uu, Xu, Uu, Uu, Uu, Chr, Tb^Tf, Tb^Tf, Uu, Tb^Tf, Uh, Uh, Chr, Uu, Uh, Uh, Uh, Uh, Uu, Uhe, Uhe, Uu, Uhe, Uu, Uh, Xu, Uh, Uh, Uh, Uh, Uh, Uh, Uh, Uh, Uh, Uu, Uu^Vu, Uh, Uh
Uu, Uu, Uu, Uu, Uu, Uu, Uu, Uu, Uu, Uu, Uu, Uu, Tb^Tf, Tb^Tf, Uu, Uu, Uu, Uu, Uh, Uh, Chr, Chr, Uh, Uh, Xu, Uh, Tb^Tf, Uu, Tb^Tf, Uhe, Uhe, Uh, Uh, Xu, Uh, Uh, Uh, Uu, Uu, Uh, Uu, Uh, Uu^Vu, Uh, Uh, Uh, Uh
Uu, Uu, Uu, Uu, Uu, Uu, Uu, Tb^Tf, Uu, Uu, Tb^Tf, Tb^Tf, Tb^Tf, Uu, Uu, Uu, Xu, Uu, Uh, Uu, Uu, Uh, Xu, Xu, Xu, Xu, Xu, Tb^Tf, Xu, Tb^Tf, Tb^Tf, Uu, Uu, Xu, Xu, Xu, Xu, Xu, Xu, Uh, Xu, Xu, Uu, Uh, Uh, Uh, Xu
Uu, Uu, Uu, Uu, Uu, Uu, Uu, Tb^Tf, Tb^Tf, Tb^Tf, Uu, Tb^Tf, Uu, Uu, Xu, Xu, Uu, Xu, Xu, Xu, Xu, Xu, Uh, Uh, Uh, Uh, Uh, Xu, Xu, Xu, Xu, Tb^Tf, Tb^Tf, Uh, Uh, Uu, Uu, Uu, Xu, Xu, Uhe, Uu, Xu, Uh, Xu, Xu, Xu
Uu, Uu, Uu, Uu, Uu, Uu, Uu, Xu, Xu, Uu, Uu, Uu, Uu, Xu, Xu, Uhe, Uhe, Xu, Uh, Uh, Uh, Uh, Uu, Uu, Uu, Uh, Uh, Uu, Qxu, Qxu, Qxu, Uu, Tb^Tf, Tb^Tf, Tb^Tf, Uu, Uu, Uu, Xu, Uu, Uu, Uhe, Uu, Xu, Uhe, Uhe, Uhe
Uu, Uu, Uu, Uu, Uu, Uu, Uu, Uu, Uu, Xu, Xu, Uu, Uu, Uu, Uu, Xu, Uu, Uhe, Uhe, Chr, Uhe, Uh, Uh, Chr, Uu, Uh, Uu, Uu, Qxu, Qxu, Qxu, Qxu, Tb^Tf, Tb^Tf, Tb^Tf, Tb^Tf, Tb^Tf, Uu, Xu, Uu, Uu, Uhe, Uhe, Uu, Uhe, Uhe, Uhe
Uu, Uu, Uu, Uu, Uu, Uu, Uu, Uu, Uu, Uu, Uu, Xu, Uu, Uu, Uu^Vu, Xu, Uu, Uu, Uu, Uhe, Uhe, Uhe, Uu, Uh, Uu, Uu, Uhe, Uhe, Qxu, Qxu, Ch, Tb^Tf, Tb^Tf, Tb^Tf, Tb^Tf, Uu, Uu, Tb^Tf, Xu, Uu, Uu, Uu, Uu, Uhe, Uu, Uu, Uhe
Uu, 6 Uu, Uu, Uu, Uu, Uu, Uu, Uu, Uu, Uu, Uu, Xu, Xu, Uu^Vu, Xu, Xu, Uu, Uu, Uu, Tb^Tf, Tb^Tf, Uu, Uu, Uu, Uu, Uhe, Uhe, Uhe, Uhe, 5 Khr, Chr, Uu, Uhe, Uu, Uu, Uu, Uu, Uu, Xu, Uu, Uu, Uu, Uu, Uu, Uu, Uu, Uu
Uu, Uu, Uu, Uu, Uu, Uu, Uu, Uu, Uu, Uu, Uhe, Uu, Xu, Xu, Uu, Xu, Xu, Uu, Uu, Uu, Uu, Tb^Tf, Uu, Uu, Uu, Uhe, Chr, Uhe, Uhe, Chr, Chr, Uhe, Uu, Uhe, Uu, Uhe, Uhe, Uu, Uh, Uh, Uh, Xu, Uu, Uu, Uu, Chr, Uu
Uu, Uu, Uu, Uu, Uu, Uu, Uu, Uu, Uu, Uhe, Xu, Xu, Xu, Uu, Uu, Uu, Uu, Xu, Xu, Uu, Uu, Tb^Tf, Tb^Tf, Uu, Uhe, Uhe, Chr, Uhe, Chr, Chr, Uhe, Uhe, Uhe, Uu, Uu, Uu, Uu, Uhe, Xu, Xu, Xu, Xu, Uu, Uu, Uh, Chr, Uh
Uu, Uu, Uu, Uu, 1 Uu, Uu, Uu, Uu, Uu, Uu, Uu, Uu, Uh, Uh, Uh, Uu, Uu, Uu, Uu, Xu, Qxu, Uu, Tb^Tf, Tb^Tf, Uu, Uhe, Chr, Uhe, Uhe, Chr, Uhe, Uhe, Uhe, Uhe, Uhe, Uhe, Xu, Xu, Uu, Uu, Uu, Uu, Uu, Uu, 3 Khr, Chr, Chr
Xu, Xu, Xu, Uu, Uu, Uu, Uu, Uu, Uu, Uu, Xu, Uu, Uu, Uh, Uh, Uh, Uu, Uu, Uu, Xu, Xu, Qxu, Uu, Tb^Tf, Uu, Uhe, Uhe, Uhe, Qxu, Uhe, Uhe, Uhe, Uhe, Uhe, Uhe, Xu, Uh, Uh, Uh, Uu, Uh, Uu, Uu, Uu, Chr, Chr, Chr
Uu, Uu^Vu, Uu, Xu, Xu, Uu, Xu, Uu, Uu, Xu, Uu, Uu, Uu, Uu, Xu, Uh, Xu, Uh, Uh, Uu, Xu, Xu, Tb^Tf, Uu, Uu, Uu, Uu, Qxu, Qxu, Qxu, Uhe, Uhe, Xu, Xu, Xu, Xu, Xu, Uh, Uh, Uu, Uh, Uu, Uh, Uh, Chr, Chr, Uh
Uu, Uu, Uu, Uu^Vu, Uu, Xu, Uu, Xu, Xu, Xu, Xu, Uu, Xu, Xu, Uu, Xu, Uhe, Xu, Xu, Uu, Uu, Uu, Uu, Tb^Tf, Tb^Tf, Tb^Tf, Uu, Qxu, Qxu, Qxu, Xu, Xu, Uu, Uu, Tb^Tf, Uu^Vu, Xu, Uu, Uhe, Uu, Uhe, Uh, Uu, Uh, Uh, Uh, Uu
Uu, Uu, Uu, Uu, Uu, Uu, Uu, Uu, Uu, Uu, Xu, Xu, Uu, Uu, Uhe, Uhe, Uu, Uu, Uu, Xu, Uu, Uu, Uu, Uu, Tb^Tf, Tb^Tf, Tb^Tf, Tb^Tf, Tb^Tf, Tb^Tf, Xu, Uu^Vu, Tb^Tf, Tb^Tf, Tb^Tf, Uu, Uu, Xu, Xu, Uhe, Uu, Uhe, Xu, Uhe, Uhe, Uu, Uu
Uu, Uu, Uu, Uu, Uu, Xu, Xu, Xu, Xu, Xu, Uu, Uu, Chr, Uu, Uhe, Uhe, Uu, Uu, Uu^Vu, Xu, Uu, Uu, Uhe, Uu, Uu, Uu, Uu, Uu, Uu, Xu, Xu, Xu, Uu, Tb^Tf, Tb^Tf, Tb^Tf, Uhe, Uu, Xu, Uu, Uu, Uu, Uh, Xu, Xu, Uhe, Uhe
Uu, Uu, Uu, Uu, Uu, Uu, Uu, Uu, Uu, Uu, Xu, Khr, Uhe, Uhe, Uu, Uu, Uu, Uu, Uu, Xu, Xu, Uu, Uu, Uhe, Uhe, Uu, Uhe, Uu, Uhe, Uu, Xu, Xu, Uhe, Uu, Uhe, Uhe, Uu, Uu^Vu, Xu, Xu, Uu, Uh, Xu, Uh, Xu, Uh, Uh
Xu, Uu^Vu, Xu, Uu, Xu, Uu^Vu, Xu, Uu, Xu, Xu, Xu, Xu, Xu, Uu, Uu, Uu, Uu, Uu, Uu, Xu, Uu, Uhe, Uh, Uu, Uhe, Uhe, Uu, Uhe, Xu, Xu, Uhe, Uhe, Uhe, Uhe, Uu, Uh, Uh, Xu, Xu, Uu, Uu, Uu, Xu, Xu, Uu, Uu, Uu
Xu, Xu, Xu, Xu, Xu, Xu, Xu, Xu, Xu, Xu, Xu, Xu, Xu, Xu, Xu, Uu, Xu, Uu, Xu, Uu, Uu, Uu, Uh, Uh, Uh, Uh, Xu, Xu, Xu, Uu^Vu, Uu, Uhe, Uhe, Uu, Uu, Uh, Uu, Uh, Uh, Uh, Uu, Uu, Xu, Uhe, Uhe, Uu, Uu
Xu, Xu, Xu, Xu, Xu, Xu, Xu, Xu, Xu, Xu, Xu, Xu, Xu, Xu, Qxu, Xu, Uu, Xu, Uu, Uu, Uu, Uu, Uh, Uh, Uu, Xu, Uu, Uu^Vu, Xu, Uh, Uu, Uhe, Uh, Uh, Uu, Uu^Vu, Xu, Uh, Uh, Uh, Uh, Uu, Xu, Uu^Vu, Uh, Uh, Uh
Xu, Xu, Xu, Xu, Xu, Xu, Xu, Xu, Xu, Xu, Xu, Xu, Xu, Xu, Xu, Qxu, Uu, Uu, Uu, Uu, Uh, Uu, Uh, Uu, Uh, Xu, Uu, Uh, Tb^Tf, Xu, Xu, Tb^Tf, Tb^Tf, Uh, Xu, Xu, Xu, Xu, Uu, Uh, Uu, Xu, Xu, Xu, Xu, Uu^Vu, Uh
Xu, Xu, Xu, Xu, Xu, Xu, Xu, Xu, Xu, Xu, Xu, Xu, Xu, Xu, Xu, Qxu, Qxu, Uu, Uu, Tb^Tf, Tb^Tf, Uu, Uhe, Uhe, Uhe, Uhe, Uhe, Uhe, Uu, Tb^Tf, Xu, Uu^Vu, Xu, Xu, Xu, Xu, Tb^Tf, Uu, Tb^Tf, Tb^Tf, Tb^Tf, Xu, Xu, Xu, Xu, Xu, Xu
Xu, Xu, Xu, Xu, Xu, Xu, Xu, Xu, Xu, Xu, Xu, Xu, Xu, Xu, Xu, Xu, Qxu, Qxu, Qxu, Uu, Uu, Tb^Tf, Tb^Tf, Uhe, Uu, Uhe, Uu, Uhe, Uu, Uu, Xu, Xu, Xu, Xu, Uu, Uu, Uu, Tb^Tf, Uu, Uu, Uu, Uu^Vud, Uu, Xu, Xu, Xu, Xu
Xu, Xu, Xu, Xu, Xu, Xu, Xu, Xu, Xu, Xu, Xu, Xu, Xu, Xu, Xu, Xu, Xu, Qxu, Qxu, Qxu, Xu, Xu, Xu, Uu, Xu, Xu, Xu, Xu, Xu, Xu, Xu, Xu, Xu, Uu, Uu^Vud, Uu, Uu, Uu, Cud, Cud, Cud, Uu, Uu, Uu, Uu, Xu, Xu
Xu, Xu, Xu, Xu, Xu, Xu, Xu, Xu, Xu, Xu, Xu, Xu, Xu, Xu, Xu, Xu, Xu, Xu, Xu, Xu, Xu, Xu, Xu, Xu, Xu, Xu, Xu, Xu, Xu, Xu, Xu, Xu, Xu, Uu, Uu, Uu, Uu, Cud, Cud, 2 Kud, Cud, Cud, Uu, Uu, Uu^Vud, Uu, Xu
Xu, Xu, Xu, Xu, Xu, Xu, Xu, Xu, Xu, Xu, Xu, Xu, Xu, Xu, Xu, Xu, Xu, Xu, Xu, Xu, Xu, Xu, Xu, Xu, Xu, Xu, Xu, Xu, Xu, Xu, Xu, Xu, Xu, Uu, Uu^Vud, Uu, Uu, Cud, Cud, Cud, Uu, Uu, Uu, Uu, Uu, Uu, Uu
Xu, Xu, Xu, Xu, Xu, Xu, Xu, Xu, Xu, Xu, Xu, Xu, Xu, Xu, Xu, Xu, Xu, Xu, Xu, Xu, Xu, Xu, Xu, Xu, Xu, Xu, Xu, Xu, Xu, Xu, Xu, Xu, Xu, Uu, Uu, Uu, Uu, Uu, Uu, Uu, Uu, Uu, Uu, Uu, Uu^Vud, Uu, Uu^Vud
