Xu, Xu, Xu, Xu, Xu, Xu, Xu, Xu, Xu, Xu, Xu, Xu, Xu, Xu, Xu, Xu, Xu, Xu, Xu, Xu, Xu, Xu, Xu, Xu, Xu, Xu, Xu, Xu, Xu, Xu, Xu, Xu, Xu, Xu, Xu, Xu, Xu, Xu, Xu, Xu, Xu, Xu, Xu, Xu, Xu, Xu, Xu, Xu, Xu, Xu, Xu, Xu, Xu, Xu, Xu, Xu, Xu, Xu, Xu, Xu, Xu, Xu, Xu, Xu, Xu, Xu, Xu, Xu, Xu, Xu, Xu, Xu, Xu, Xu, Xu, Xu, Xu, Xu, Xu
Xu, Xu, Xu, Xu, Xu, Xu, Xu, Xu, Xu, Xu, Xu, Xu, Xu, Xu, Xu, Xu, Xu, Xu, Xu, Xu, Xu, Xu, Xu, Xu, Xu, Xu, Xu, Xu, Xu, Xu, Xu, Xu, Xu, Xu, Xu, Xu, Xu, Xu, Xu, Xu, Xu, Xu, Xu, Xu, Xu, Xu, Xu, Xu, Xu, Xu, Xu, Xu, Xu, Xu, Xu, Xu, Xu, Xu, Xu, Xu, Xu, Xu, Xu, Xu, Xu, Xu, Xu, Xu, Xu, Xu, Xu, Xu, Xu, Xu, Xu, Xu, Xu, Xu, Xu
Xu, Xu, Xu, Xu, Xu, Xu, Xu, Xu, Xu, Xu, Xu, Xu, Xu, Xu, Xu, Xu, Xu, Xu, Xu, Xu, Xu, Xu, Xu, Xu, Xu, Xu, Xu, Xu, Xu, Xu, Xu, Xu, Xu, Xu, Xu, Xu, Xu, Xu, Xu, Xu, Xu, Xu, Xu, Xu, Xu, Xu, Xu, Xu, Xu, Xu, Xu, Xu, Xu, Xu, Xu, Xu, Xu, Xu, Xu, Xu, Xu, Xu, Xu, Xu, Xu, Xu, Xu, Xu, Xu, Xu, Xu, Xu, Xu, Xu, Xu, Xu, Xu, Xu, Xu
Xu, Xu, Xu, Xu, Xu, Xu, Xu, Xu, Xu, Xu, Xu, Xu, Xu, Xu, Xu, Xu, Xu, Xu, Xu, Xu, Xu, Xu, Xu, Xu, Xu, Xu, Xu, Xu, Xu, Xu, Xu, Xu, Xu, Xu, Xu, Xu, Xu, Xu, Xu, Xu, Xu, Xu, Xu, Xu, Xu, Xu, Xu, Xu, Xu, Xu, Xu, Xu, Xu, Xu, Xu, Xu, Xu, Xu, Xu, Xu, Xu, Xu, Xu, Xu, Xu, Xu, Xu, Xu, Xu, Xu, Xu, Xu, Xu, Xu, Xu, Xu, Xu, Xu, Xu
Xu, Xu, Xu, Xu, Xu, Xu, Xu, Xu, Xu, Xu, Xu, Xu, Xu, Xu, Xu, Xu, Xu, Xu, Xu, Xu, Xu, Xu, Xu, Xu, Xu, Xu, Xu, Xu, Xu, Xu, Xu, Xu, Xu, Xu, Xu, Xu, Xu, Xu, Xu, Xu, Xu, Xu, Xu, Xu, Xu, Xu, Xu, Xu, Xu, Xu, Xu, Xu, Xu, Xu, Xu, Xu, Xu, Xu, Xu, Xu, Xu, Xu, Xu, Xu, Xu, Xu, Xu, Xu, Xu, Xu, Xu, Xu, Xu, Xu, Xu, Xu, Xu, Xu, Xu
Xu, Xu, Xu, Xu, Xu, Xu, Xu, Xu, Xu, Xu, Xu, Xu, Xu, Xu, Xu, Xu, Xu, Xu, Xu, Xu, Xu, Xu, Xu, Xu, Xu, Xu, Xu, Xu, Xu, Xu, Xu, Xu, Xu, Xu, Xu, Xu, Xu, Xu, Xu, Xu, Xu, Xu, Xu, Xu, Xu, Xu, Xu, Xu, Xu, Xu, Xu, Xu, Xu, Xu, Xu, Xu, Xu, Xu, Xu, Xu, Xu, Xu, Xu, Xu, Xu, Xu, Xu, Xu, Xu, Xu, Xu, Xu, Xu, Xu, Xu, Xu, Xu, Xu, Xu
Xu, Xu, Xu, Xu, Xu, Xu, Xu, Xu, Xu, Xu, Xu, Xu, Xu, Xu, Xu, Xu, Xu, Xu, Xu, Xu, Xu, Xu, Xu, Xu, Xu, Xu, Xu, Xu, Xu, Xu, Xu, Xu, Xu, Xu, Xu, Xu, Xu, Xu, Xu, Xu, Xu, Xu, Xu, Xu, Xu, Xu, Xu, Xu, Xu, Xu, Xu, Xu, Xu, Xu, Xu, Xu, Xu, Xu, Xu, Xu, Xu, Xu, Xu, Xu, Xu, Xu, Xu, Xu, Xu, Xu, Xu, Xu, Xu, Xu, Xu, Xu, Xu, Xu, Xu
Xu, Xu, Xu, Xu, Xu, Xu, Xu, Xu, Xu, Xu, Xu, Xu, Xu, Xu, Xu, Xu, Xu, Xu, Xu, Xu, Xu, Xu, Xu, Xu, Xu, Xu, Xu, Xu, Xu, Xu, Xu, Xu, Xu, Xu, Xu, Xu, Xu, Xu, Xu, Xu, Xu, Xu, Xu, Xu, Xu, Xu, Xu, Xu, Xu, Xu, Xu, Xu, Xu, Xu, Xu, Xu, Xu, Xu, Xu, Xu, Xu, Xu, Xu, Xu, Xu, Xu, Xu, Xu, Xu, Xu, Xu, Xu, Xu, Xu, Xu, Xu, Xu, Xu, Xu
Xu, Xu, Xu, Xu, Xu, Xu, Xu, Xu, Xu, Xu, Xu, Xu, Xu, Xu, Xu, Xu, Xu, Xu, Xu, Xu, Uu, Xu, Xu, Xu, Xu, Xu, Xu, Xu, Xu, Xu, Xu, Xu, Xu, Xu, Xu, Xu, Xu, Xu, Xu, Xu, Xu, Xu, Xu, Xu, Xu, Xu, Xu, Xu, Uu, Xu, Uu, Xu, Uu, Xu, Uu, Xu, Xu, Xu, Xu, Xu, Xu, Xu, Xu, Xu, Xu, Xu, Xu, Xu, Xu, Xu, Xu, Xu, Xu, Xu, Xu, Xu, Xu, Xu, Xu
Xu, Xu, Xu, Xu, Xu, Xu, Xu, Xu, Xu, Xu, Xu, Xu, Xu, Xu, Xu, Xu, Uu, Uu, Uu, Uu, Uu, Uu, Uu, Uu, Uu, Xu, Xu, Xu, Xu, Xu, Xu, Xu, Xu, Xu, Xu, Xu, Xu, Xu, Xu, Xu, Uu, Chr, Chr, Ch, Ch, Ch, Uu, Uu, Uu, Uu, Uh, Uh, Uh, Uu, Uu, Uu, Uu, Xu, Uu, Qxu, Qxu, Xu, Qxu, Xu, Xu, Xu, Xu, Xu, Xu, Xu, Xu, Xu, Xu, Xu, Xu, Xu, Xu, Xu, Xu
Xu, Xu, Xu, Xu, Xu, Xu, Xu, Xu, Xu, Xu, Xu, Xu, Xu, Xu, Ch, Uu, Uu, Uu, Uu, Uu, Uu, Uu, Uu, Uu, Uu, Uu, Uu, Xu, Uu, Xu, Xu, Xu, Xu, Xu, Xu, Xu, Qxu, Xu, Uu, Uu, Uu, Chr, Uu, Chr, Uh, Uh, Uh, Uh, Uu, Uu, Uh, Uu, Uh, Uu, Uu, Uu, Uh, Uh, Uh, Uu, Uu, Qxu, Uu, Uu, Uu, Xu, Xu, Xu, Xu, Xu, Xu, Xu, Xu, Xu, Xu, Xu, Xu, Xu, Xu
Xu, Xu, Xu, Xu, Xu, Xu, Xu, Xu, Xu, Xu, Xu, Xu, Ch, Ch, Ch, Uu, Tb^Tf, Uu, Uu, Uu, Uu, Uu, Uu, Uu, Uh, Uh, Uh, Uhe, Uhe, Uu, Uu, Uu, Uu, Xu, Qxu, Qxu, Qxu, Uu, Uu, Uu, Uh, Uh, Uh, Uh, Uh, Uu, Uh, Uh, Uu, Uu, Uh, Uu, Uh, Uu, Uh, Uh, Uu, Uu, Uu, Uu, Uh, Uu, Uu, Uu, Uu, Uu, Uu, Xu, Xu, Xu, Xu, Xu, Xu, Xu, Xu, Xu, Xu, Xu, Xu
Uu^Ii, Xu, Uu^Ii, Xu, Uu^Ii, Xu, Uu^Ii, Xu, Uu, Xu, Uu, Uu, Uu, Ch, Tb^Tf, Tb^Tf, Uu, Tb^Tf, Uh, Uh, Chr, Uu, Uh, Uh, Uh, Uh, Uu, Uhe, Uhe, Uu, Uhe, Uu, Uh, Uh, Uh, Uh, Uh, Uh, Uh, Uh, Uh, Uh, Uh, Uu, Uu, Uh, Uh, Uh, Uu, Uu, Tb^Tf, Uu, Uu, Uh, Uh, Uu, Uu, Uu, Uu, Uu, Uu, Uu, Uhe, Uhe, Uhe, Uu, Uu, Uu, Uhe, Xu, Xu, Xu, Xu, Xu, Xu, Xu, Xu, Xu, Xu
Uu^Ii, Uu^Ii, Uu^Ii, Uu^Ii, Uu^Ii, Uu^Ii, Uu^Ii, Uu, Uu, Uu, Uu, Uu, Tb^Tf, Tb^Tf, Uu, Uu, Uu, Uu, Uh, Uh, Chr, Chr, Uh, Uh, Uu, Uh, Tb^Tf, Uu, Tb^Tf, Uhe, Uhe, Uh, Uh, Uh, Uh, Uh, Uh, Uu, Uu, Uh, Uu, Uh, Uu, Uh, Uh, Uh, Uh, Uh, Tb^Tf, Tb^Tf, Tb^Tf, Uh, Uu, Uh, Uh, Uu, Uu, Uu, Uh, Uu, Uu, Uu, Uh, Uhe, Uu, Uhe, Uhe, Uhe, Qxu, Qxu, Xu, Xu, Uu, Uu, Uu, Uu, Uu, Xu, Xu
Uu^Ii, Uu^Ii, Uu^Ii, Uu^Ii, Uu^Ii, Uu^Ii, Uu^Ii, Tb^Tf, Uu, Uu, Tb^Tf, Tb^Tf, Tb^Tf, Uu, Uu, Uu, Uu, Uu, Uh, Uu, Uu, Uh, Uh, Uu, Uu, Uh, Uu, Tb^Tf, Uu, Tb^Tf, Tb^Tf, Uu, Uu, Uh, Uu, Uh, Uu, Uh, Uh, Uh, Uu, Uu, Uu, Uh, Uh, Uh, Uu, Tb^Tf, Tb^Tf, Tb^Tf, Chr, Chr, Uh, Uu, Uu, Uh, Uh, Uh, Uh, Uh, Uh, Uu, Uh, Uu, Uu, Uhe, Uu, Uhe, Xu, Xu, Xu, Xu, Uu, Uu, Uu, Uu^Vud, Uu, Xu, Xu
Uu^Ii, Uu^Ii, Uu^Ii, Uu^Ii, Uu^Ii, Uu^Ii, Uu^Ii, Tb^Tf, Tb^Tf, Tb^Tf, Uu, Tb^Tf, Uu, Uu, Uu, Uu, Uu, Uu, Uh, Uu, Uu, Uh, Uh, Uh, Uh, Uh, Uh, Uu, Uu, Uu, Uu, Tb^Tf, Tb^Tf, Uh, Uh, Uu, Uu, Uu, Uh, Uh, Uhe, Uu, Uu, Uh, Uu, Uu, Uu, Tb^Tf, Tb^Tf, Tb^Tf, Tb^Tf, Chr, Uhe, Uhe, Uhe, Uhe, Uhe, Uh, Uu, Uu, Uh, Uh, Uu, Uh, Uhe, Uhe, Uu, Uu, Xu, Xu, Xu, Uu, Uu, Uu^Vud, Uu, Uu, Uu, Xu, Xu
Uu^Ii, Uu^Ii, Uu^Ii, Uu^Ii, Uu^Ii, Uu^Ii, Uu^Ii, Uu, Uu, Uu, Uu, Uu, Uu, Uu, Uu, Uhe, Uhe, Uu, Uh, Uh, Uh, Uh, Uu, Uu, Uu, Uh, Uh, Uu, Uu, Uu, Uu, Uu, Tb^Tf, Tb^Tf, Tb^Tf, Uu, Uu, Uu, Uu, Uu, Uu, Uhe, Uu, Uu, Uhe, Uhe, Uhe, Tb^Tf, Tb^Tf, Tb^Tf, Tb^Tf, Chr, Uhe, Uu, Uu, Uh, Uh, Uhe, Uh, Uu, Uh, Uhe, Uhe, Uhe, Uhe, Uh, Uu, Uu, Xu, Xu, Xu, Uu, Uu^Vud, Uu, Uu, Uu, Uu^Vud, Xu, Xu
Uu^Ii, Uu^Ii, Uu^Ii, Uu^Ii, Uu^Ii, Uu^Ii, Uu^Ii, Uu, Uu, Uu, Uu, Uu, Uu, Uu, Uu, Uu, Uu, Uhe, Uhe, Chr, Uhe, Uh, Uh, Chr, Uu, Uh, Uu, Uu, Uhe, Uhe, Uu, Uu, Tb^Tf, Tb^Tf, Tb^Tf, Tb^Tf, Tb^Tf, Uu, Uu, Uu, Uu, Uhe, Uhe, Uu, Uhe, Uhe, Uhe, Uu, Uu, Tb^Tf, Tb^Tf, Tb^Tf, Tb^Tf, Uhe, Uhe, Uu, Uh, Uhe, Uh, Uh, Uh, Uu, Uh, Uu, Uu, Uh, Uh, Uu, Xu, Xu, Xu, Uu, Uu, Uu, Uu, Uu, Uu, Xu, Xu
Uu^Ii, Uu^Ii, Uu^Ii, Uu^Ii, Uu^Ii, Uu^Ii, Uu^Ii, Uu, Uu, Uu, Uu, Uu, Uu, Uu, Uu, Uu, Uu, Uu, Uu, Uhe, Uhe, Uhe, Uu, Uh, Uu, Uu, Uhe, Uhe, Uu, Uu, Ch, Tb^Tf, Tb^Tf, Tb^Tf, Tb^Tf, Uu, Uu, Tb^Tf, Uu, Uu, Uu, Uu, Uu, Uhe, Uu, Uu, Uhe, Uu, Uu, Uu, Uu, Tb^Tf, Tb^Tf, Uu, Uh, Uu, Uh, Uhe, Uu, Uu, Uh, Uh, Uu, Uh, Uh, Uh, Uu, Uh, Xu, Xu, Xu, Uu, Uu, Uu^Vud, Uu, Uu^Vud, Uu, Xu, Xu
Uu^Ii, 6 Uu^Ii, Uu^Ii, Uu^Ii, Uu^Ii, Uu^Ii, Uu^Ii, Uu, Uu, Uu, Uu, Uu, Uu, Uu, Uu, Uu, Uu, Uu, Uu, Tb^Tf, Tb^Tf, Uu, Uu, Uu, Uu, Uhe, Uhe, Uhe, Uhe, Khr, Chr, Uu, Uhe, Uu, Uu, Uu, Uu, Uu, Uu, Uu, Uu, Uu, Uu, Uu, Uu, Uu, Uu, Uu, Uu, Uu, Uh, Uh, Uu, Uh, Chr, Uh, Uh, Uh, Uh, Uu, Uu, Uu, Tb^Tf, Uu, Uh, Uu, Uu, Uh, Uu, Xu, Xu, Uu, Uu^Vud, Uu, Uu, Uu, Uu, Xu, Xu
Uu^Ii, Uu^Ii, Uu^Ii, Uu^Ii, Uu^Ii, Uu^Ii, Uu^Ii, Uu, Uu, Uu, Uhe, Uu, Uu, Uu, Uu, Uu, Uu, Uu, Uu, Uu, Uu, Tb^Tf, Uu, Uu, Uu, Uhe, Chr, Uhe, Uhe, Chr, Chr, Uhe, Uu, Uhe, Uu, Uhe, Uhe, Uu, Uh, Uh, Uh, Uu, Uu, Uu, Uu, Uu, Uu, Uu, Uu, Uu, Uu, Uh, Uh, Chr, Uh, Uh, Uu, Uu, Uu, Tb^Tf, Tb^Tf, Tb^Tf, Tb^Tf, Tb^Tf, Tb^Tf, Uu, Uh, Uu, Uu, Xu, Xu, Uu, Uu, Uu, Cud, Uu, Xu, Xu, Xu
Uu^Ii, Uu^Ii, Uu^Ii, Uu^Ii, Uu^Ii, Uu^Ii, Uu^Ii, Uu, Uu, Uhe, Uu, Uhe, Uhe, Uu, Uu, Uu, Uu, Uu, Uu, Uu, Uu, Tb^Tf, Tb^Tf, Uu, Uhe, Uhe, Chr, Uhe, Chr, Uhe, Uhe, Uhe, Uhe, Uu, Uu, Uu, Uu, Uhe, Uu, Uu, Uu, Uh, Uu, Uu, Uh, Uu, Uh, Uu, Uh, Uu, Uhe, Uhe, Uu, Chr, Uu, Uu, Uhe, Uu, Uu, Uu, Uu, Tb^Tf, Tb^Tf, Uh, Tb^Tf, Uh, Uu, Uu, Xu, Xu, Xu, Xu, Cud, Cud, Cud, Cud, Cud, Xu, Xu
Uu^Ii, Uu^Ii, Uu^Ii, Uu^Ii, 1 Uu^Ii, Uu^Ii, Uu^Ii, Uu, Uu, Uu, Uu, Uu, Uh, Uh, Uh, Uu, Uu, Uu, Uu, Uu, Uu, Uu, Tb^Tf, Tb^Tf, Uu, Uhe, Chr, Uhe, Uhe, Chr, Uhe, Uhe, Uhe, Uhe, Uhe, Uhe, Uhe, Uhe, Uu, Uu, Uu, Uu, Uu, Uu, Uu, Uu, Uu, Uu, Uu, Uu, Uu, Uu, Uu, Uu, Uhe, Uhe, Uhe, Uhe, Uu, Uu, Uu, Tb^Tf, Tb^Tf, Tb^Tf, Tb^Tf, Qxu, Qxu, Xu, Xu, Xu, Xu, Xu, Cud, Cud, 3 Kud, Cud, Cud, Xu, Xu
Uu^Ii, Uu^Ii, Uu^Ii, Uu^Ii, Uu^Ii, Uu^Ii, Uu^Ii, Uu, Uu, Uu, Uu, Uu, Uu, Uh, Uh, Uh, Uu, Uu, Uu, Uu, Uu, Uu, Uu, Tb^Tf, Uu, Uhe, Uhe, Uhe, Uu, Uhe, Uhe, Uhe, Uhe, Uhe, Uhe, Uu, Uh, Uh, Uh, Uu, Uh, Uu, Uu, Uu, Uu, Uu, Uu, Uu, Uu, Uu, Uu, Uu, Uu, Uu, Uhe, Uu, Uu, Uhe, Uu, Uu, Uu, Tb^Tf, Tb^Tf, Tb^Tf, Tb^Tf, Qxu, Qxu, Xu, Xu, Xu, Xu, Xu, Cud, Cud, Cud, Cud, Cud, Xu, Xu
Uu^Ii, Uu^Ii, Uu^Ii, Uu^Ii, Uu^Ii, Uu^Ii, Uu^Ii, Uu, Uu, Uu, Uu, Uu, Uu, Uu, Uu, Uh, Uh, Uh, Uh, Uu, Uu, Uu, Tb^Tf, Uu, Uu, Uu, Uu, Uu, Uu, Uu, Uhe, Uhe, Uhe, Uhe, Uu, Uu, Uu, Uh, Uh, Uu, Uh, Uu, Uh, Uh, Uu, Uu, Uh, Uu, Uu, Uu, Uu, Uu, Uhe, Uhe, Uu, Uu, Uu, Uu, Uu, Uu, Uu, Uu, Uu, Tb^Tf, Uu, Qxu, Xu, Xu, Xu, Xu, Xu, Xu, Uu, Cud, Cud, Cud, Uu, Xu, Xu
Uu^Ii, Uu^Ii, Uu^Ii, Uu^Ii, Uu^Ii, Uu^Ii, Uu^Ii, Uu, Uu, Uu, Uu, Uu, Uu, Uu, Uu, Uu, Uhe, Uu, Uu, Uu, Uu, Uu, Uu, Tb^Tf, Tb^Tf, Tb^Tf, Uu, Uu, Tb^Tf, Uu, Uu, Uu, Uu, Uu, Tb^Tf, Uu, Uu, Uu, Uhe, Uu, Uhe, Uh, Uu, Uh, Uh, Uh, Uu, Uu, Uu, Uu, Uu, Uu, Uu, Uu, Uu, Uu, Uu, Uu, Uu, Uu, Uh, Uu, Uh, Uh, Uh, Qxu, Xu, Xu, Xu, Xu, Uu, Uu, Uu, Uu, Uu, Uu, Uu, Uu, Xu
Uu^Ii, Uu^Ii, Uu^Ii, Uu^Ii, Uu^Ii, Uu^Ii, Uu^Ii, Uu, Uu, Uu, Uu, Uu, Uu, Uu, Uhe, Uhe, Uu, Uu, Uu, Uu, Uu, Uu, Uu, Uu, Tb^Tf, Tb^Tf, Tb^Tf, Tb^Tf, Tb^Tf, Tb^Tf, Tb^Tf, Tb^Tf, Tb^Tf, Tb^Tf, Tb^Tf, Uu, Uu, Uu, Uu, Uhe, Uu, Uhe, Uhe, Uhe, Uhe, Uu, Uu, Uu, Uu, Uu, Uu, Uu, Uu, Uu, Uu, Uh, Uh, Uh, Uh, Uh, Uu, Uh, Uh, Uh, Uu, Qxu, Xu, Xu, Xu, Xu, Uu, Uu, Uu, Uu, Uu, Uu, Uu, Uu, Xu
Uu^Ii, Uu^Ii, Uu^Ii, Uu^Ii, Uu^Ii, Uu^Ii, Uu^Ii, Uu, Uu, Uu, Uu, Uu, Ch, Uu, Uhe, Uhe, Uu, Uu, Uu, Uu, Uu, Uu, Uhe, Uu, Uu, Uu, Uu, Uu, Uu, Uu, Uu, Tb^Tf, Uu, Tb^Tf, Tb^Tf, Tb^Tf, Uhe, Uu, Uu, Uu, Uu, Uu, Uh, Uhe, Uh, Uhe, Uhe, Uu, Uu, Uu, Uu, Uu, Uu, Uu, Uu, Uh, Uh, Uh, Uu, Uh, Uu, Uu, Uu, Uh, Uu, Uu, Xu, Xu, Xu, Xu, Uu, Uu, Uu, Uu, Uu, Uu, Uu, Uu, Xu
Uu^Ii, Uu^Ii, Uu^Ii, Uu^Ii, Uu^Ii, Uu^Ii, Uu^Ii, Uu, Uu, Uu, Xu, Khr, Uhe, Uhe, Tb^Tf, Tb^Tf, Tb^Tf, Tb^Tf, Tb^Tf, Uu, Uu, Uu, Uu, Uhe, Uhe, Uu, Uhe, Uu, Uhe, Uu, Uhe, Uu, Uhe, Uu, Uhe, Uhe, Uu, Uu, Uu, Uu, Uu, Uh, Uhe, Uh, Uh, Uh, Uh, Uh, Uu, Uu, Uu, Uu, Uu, Uu, Uu, Uu, Uu, Uu, Uu, Uu, Uh, Uh, Uh, Uh, Uh, Uu, Xu, Xu, Xu, Xu, Uu, Uu, Uu, Uu, Uu, Uu, Uu, Uu, Xu
Xu, Uu^Ii, Xu, Uu^Ii, Xu, Uu^Ii, Xu, Uu, Xu, Xu, Xu, Xu, Xu, Uu, Tb^Tf, Tb^Tf, Tb^Tf, Tb^Tf, Tb^Tf, Uu, Uu, Uhe, Uh, Uu, Uhe, Uhe, Uu, Uhe, Uu, Uhe, Uhe, Uhe, Uhe, Uhe, Uu, Uh, Uh, Uh, Uu, Uu, Uu, Uu, Uhe, Uu, Uu, Uu, Uu, Uu, Uhe, Uu, Uh, Uhe, Uh, Uu, Uu, Uu, Uu, Uu, Uu, Uh, Uu, Uu, Uh, Uu, Uh, Uu, Uu, Xu, Xu, Xu, Uu, Uu, Uu, Uu, Uu, Uu, Uu, Uu, Xu
Xu, Xu, Xu, Xu, Xu, Xu, Xu, Xu, Xu, Xu, Xu, Xu, Xu, Xu, Tb^Tf, Tb^Tf, Tb^Tf, Tb^Tf, Tb^Tf, Uu, Uu, Uu, Uh, Uh, Uh, Uh, Uu, Uh, Uh, Uu, Uu, Uhe, Uhe, Uu, Uu, Uh, Uu, Uh, Uh, Uh, Uu, Uu, Uu, Uhe, Uhe, Uu, Uu, Uu, Uh, Uu, Uhe, Uh, Cud, Uh, Uh, Uu, Uu, Uh, Uh, Uh, Uh, Uh, Uh, Uh, Uu, Uu, Uu, Xu, Xu, Xu, Uu, Uu, Uu, Uu, Uu, Uu, Uu, Uu, Xu
Xu, Xu, Xu, Xu, Xu, Xu, Xu, Xu, Xu, Xu, Xu, Xu, Xu, Xu, Uu, Tb^Tf, Uu, Tb^Tf, Uu, Uu, Uu, Uu, Uh, Uh, Uu, Uu, Uu, Uu, Uh, Uh, Uu, Uhe, Uh, Uh, Uu, Uu, Uu, Uh, Uh, Uh, Uh, Uu, Uu, Uu, Uh, Uh, Uh, Uu, Uh, Uu, Uu, Cud, 5 Kud, Cud, Uu, Uh, Uh, Uu, Uu, Uh, Uu, Uh, Uu, Uu, Uu, Uu, Uu, Uu, Xu, Xu, Uu, Uu, Uu, Uu, Uu, Uu, Uu, Uu, Xu
Xu, Xu, Xu, Xu, Xu, Xu, Xu, Xu, Xu, Xu, Xu, Xu, Xu, Xu, Xu, Uu, Uu, Uu, Uu, Uu, Uh, Uu, Uh, Uu, Uh, Uu, Uu, Uh, Tb^Tf, Uh, Tb^Tf, Tb^Tf, Tb^Tf, Uh, Uu, Uh, Uu, Uu, Uu, Uh, Uu, Uu, Uu, Uu, Uh, Uu, Uh, Uh, Uu, Uu, Uu, Cud, Cud, Cud, Uu, Uu, Uu, Uu, Uu, Uu, Uu, Uu, Uu, Uu, Uu, Uu, Uh, Uu, Xu, Xu, Uu, Uu, Uu, Uu, Uu, Uu, Uu, Uu, Xu
Xu, Xu, Xu, Xu, Xu, Xu, Xu, Xu, Xu, Xu, Xu, Xu, Xu, Xu, Xu, Qxu, Qxu, Uu, Uu, Tb^Tf, Tb^Tf, Uu, Uhe, Uhe, Uhe, Uhe, Uhe, Uhe, Uu, Tb^Tf, Uu, Tb^Tf, Uu, Tb^Tf, Tb^Tf, Tb^Tf, Tb^Tf, Uu, Tb^Tf, Tb^Tf, Tb^Tf, Tb^Tf, Uu, Uu, Qxu, Uh, Qxu, Uu, Qxu, Uu, Uu, Uu, Uu, Uu, Uu, Uu, Uu, Uu, Uu, Uu, Uu, Uu, Uu, Uu, Uh, Uh, Xu, Xu, Uu, Xu, Uu, Uu, Uu, Uu, Uu^Vu, Uu, Uu, Uu, Xu
Xu, Xu, Xu, Xu, Xu, Xu, Xu, Xu, Xu, Xu, Xu, Xu, Xu, Xu, Xu, Xu, Qxu, Qxu, Qxu, Uu, Uu, Tb^Tf, Tb^Tf, Uhe, Uu, Uhe, Uu, Uhe, Uu, Uu, Xu, Uu, Xu, Uu, Xu, Uu, Uu, Tb^Tf, Xu, Xu, Xu, Uu, Xu, Uu, Xu, Qxu, Qxu, Qxu, Qxu, Qxu, Qxu, Qxu, Qxu, Uu, Xu, Uu, Xu, Uu, Uu, Uu, Xu, Uu, Xu, Uh, Xu, Uh, Uu, Uu, Uu^Vu, Uu, Uu, Uu^Vud, Uu, Uu, Uu, Uu, Uu^Vud, Uu, Ur
Xu, Xu, Xu, Xu, Xu, Xu, Xu, Xu, Xu, Xu, Xu, Xu, Xu, Xu, Xu, Xu, Xu, Qxu, Qxu, Qxu, Xu, Xu, Xu, Uu, Xu, Xu, Xu, Xu, Xu, Xu, Xu, Xu, Xu, Xu, Xu, Xu, Xu, Xu, Xu, Xu, Xu, Xu, Xu, Xu, Xu, Xu, Xu, Qxu, Xu, Qxu, Xu, Xu, Xu, Xu, Xu, Xu, Xu, Xu, Xu, Xu, Xu, Xu, Xu, Xu, Uu, Uu, Uu^Vud, Uu, Uu, Uu, Uu, Uu, Uu, Uu^Vud, Uu, Uu, Uu, Uu, Ur
Xu, Xu, Xu, Xu, Xu, Xu, Xu, Xu, Xu, Xu, Xu, Xu, Xu, Xu, Xu, Xu, Xu, Xu, Xu, Xu, Xu, Xu, Xu, Xu, Xu, Xu, Xu, Xu, Xu, Xu, Xu, Xu, Xu, Xu, Xu, Xu, Xu, Xu, Xu, Xu, Xu, Xu, Xu, Xu, Xu, Xu, Xu, Xu, Xu, Xu, Xu, Xu, Xu, Xu, Uu, Uu, Uu, Uu, Uh, Uu, Uh, Uu, Uu, Uu, Uu^Vu, Uu, Uu, Uu, Uu, Uu^Vud, Uu, Uu, Uu, Uu, Uu, Uu, Uu^Vud, Uu, Ur^Br/
Xu, Xu, Xu, Xu, Xu, Xu, Xu, Xu, Xu, Xu, Xu, Xu, Xu, Xu, Xu, Xu, Xu, Xu, Xu, Xu, Xu, Xu, Xu, Xu, Xu, Xu, Xu, Xu, Xu, Xu, Xu, Xu, Xu, Xu, Xu, Xu, Xu, Xu, Xu, Xu, Xu, Xu, Xu, Xu, Uu, Uu, Uu, Xu, Xu, Xu, Xu, Xu, Uu, Uu, Uu, Uu, Uu, Uh, Uhe, Uh, Uhe, Uh, Uh, Uu, Uu, Uu, Uu, Uu, Uu^Vud, Uu, Uu, Uu, Cud, Cud, Cud, Uu, Ur^Br/, Ur^Br/, Ur
Xu, Xu, Xu, Xu, Xu, Xu, Xu, Xu, Xu, Xu, Xu, Xu, Xu, Xu, Xu, Xu, Xu, Xu, Xu, Xu, Xu, Xu, Xu, Xu, Xu, Xu, Xu, Xu, Xu, Xu, Xu, Xu, Xu, Xu, Xu, Xu, Xu, Xu, Xu, Xu, Xu, Xu, Uu, Uu, Uu^Vud, Uu, Uu^Vud, Uu, Uu, Xu, Cud, Cud, Cud, Uu, Uu, Uu, Uu, Uhe, Uh, Uhe, Uh, Uhe, Uhe, Uh, Uh, Uu^Vud, Uu, Uu, Uu, Uu, Uu, Cud, Cud, Cud, Cud, Cud, Uu, Uu, Ur
Xu, Xu, Xu, Xu, Xu, Xu, Xu, Xu, Xu, Xu, Xu, Xu, Xu, Xu, Xu, Xu, Xu, Xu, Xu, Xu, Xu, Xu, Xu, Xu, Xu, Xu, Xu, Xu, Xu, Xu, Xu, Xu, Xu, Xu, Xu, Xu, Xu, Xu, Xu, Xu, Uu, Uu, Uu^Vud, Uu, Uu, Uu, Uu, Uu, Uu, Cud, Cud, Cud, Cud, Cud, Uu, Uu, Uu, Uhe, Uhe, Uh, Uhe, Uhe, Uhe, Uh, Uh, Uu, Uu^Vu, Uu, Uu^Vud, Uu, Uu, Cud, Cud, 2 Kud, Cud, Cud, Uu, Uu^Vud, Ur
Xu, Xu, Xu, Xu, Xu, Xu, Xu, Xu, Xu, Xu, Xu, Xu, Xu, Xu, Xu, Xu, Xu, Xu, Xu, Xu, Xu, Xu, Xu, Xu, Xu, Xu, Xu, Xu, Xu, Xu, Xu, Xu, Xu, Xu, Xu, Xu, Xu, Xu, Xu, Xu, Xu, Uu, Uu, Uu, Uu^Vud, Uu, Uu, Uu, Uu, Cud, Cud, 4 Kud, Cud, Cud, Uu, Uu, Uu, Uu, Uhe, Uh, Uh, Uh, Uh, Uh, Uh, Uh, Xu, Uu, Uu, Uu, Uu, Uu, Cud, Cud, Cud, Uu, Uu, Uu, Ur
Xu, Xu, Xu, Xu, Xu, Xu, Xu, Xu, Xu, Xu, Xu, Xu, Xu, Xu, Xu, Xu, Xu, Xu, Xu, Xu, Xu, Xu, Xu, Xu, Xu, Xu, Xu, Xu, Xu, Xu, Xu, Xu, Xu, Xu, Xu, Xu, Xu, Xu, Xu, Xu, Xu, Xu, Xu, Uu, Uu, Uu, Uu, Uu^Vud, Uu, Cud, Cud, Cud, Cud, Cud, Uu, Uu, Uu, Uu, Uu, Uu, Uu, Uu, Xu, Uh, Xu, Xu, Xu, Uu, Xu, Uu^Vu, Xu, Xu, Xu, Cud, Xu, Xu, Xu, Uu^Vu, Ur
Xu, Xu, Xu, Xu, Xu, Xu, Xu, Xu, Xu, Xu, Xu, Xu, Xu, Xu, Xu, Xu, Xu, Xu, Xu, Xu, Xu, Xu, Xu, Xu, Xu, Xu, Xu, Xu, Xu, Xu, Xu, Xu, Xu, Xu, Xu, Xu, Xu, Xu, Xu, Xu, Xu, Xu, Xu, Xu, Uu, Uu, Uu^Vud, Uu, Uu, Uu, Uu, Cud, Xu, Xu, Xu, Uu, Xu, Xu, Xu, Xu, Xu, Xu, Xu, Xu, Xu, Xu, Xu, Xu, Xu, Xu, Xu, Xu, Xu, Xu, Xu, Xu, Xu, Xu, Xu
Xu, Xu, Xu, Xu, Xu, Xu, Xu, Xu, Xu, Xu, Xu, Xu, Xu, Xu, Xu, Xu, Xu, Xu, Xu, Xu, Xu, Xu, Xu, Xu, Xu, Xu, Xu, Xu, Xu, Xu, Xu, Xu, Xu, Xu, Xu, Xu, Xu, Xu, Xu, Xu, Xu, Xu, Xu, Xu, Uu, Uu, Uu, Uu, Uu, Uu, Uu, Uu, Uu, Xu, Xu, Xu, Xu, Xu, Xu, Xu, Xu, Xu, Xu, Xu, Xu, Xu, Xu, Xu, Xu, Xu, Xu, Xu, Xu, Xu, Xu, Xu, Xu, Xu, Xu
