Xu, Xu, Xu, Xu, Xu, Xu, Xu, Xu, Xu, Xu, Xu, Xu, Xu, Xu, Xu, Xu, Xu, Xu, Xu, Xu, Xu, Xu, Xu, Xu, Xu, Xu, Xu, Xu, Xu, Xu, Xu, Xu, Xu, Xu, Xu, Xu, Xu, Xu, Xu, Xu, Xu, Xu, Xu, Xu, Xu, Xu, Xu
Xu, Xu, Xu, Xu, Xu, Xu, Xu, Xu, Xu, Xu, Xu, Xu, Xu, Xu, Xu, Xu, Xu, Xu, Xu, Xu, Xu, Xu, Xu, Xu, Xu, Xu, Xu, Xu, Xu, Xu, Xu, Xu, Xu, Xu, Xu, Xu, Xu, Xu, Xu, Xu, Xu, Xu, Xu, Xu, Xu, Xu, Xu
Xu, Xu, Xu, Xu, Xu, Xu, Xu, Xu, Xu, Xu, Xu, Xu, Xu, Xu, Xu, Xu, Xu, Xu, Xu, Xu, Xu, Xu, Xu, Xu, Xu, Xu, Xu, Xu, Xu, Xu, Xu, Xu, Xu, Xu, Xu, Xu, Xu, Xu, Xu, Xu, Xu, Xu, Xu, Xu, Xu, Xu, Xu
Xu, Xu, Xu, Xu, Xu, Xu, Xu, Xu, Xu, Xu, Xu, Xu, Xu, Xu, Xu, Xu, Xu, Xu, Xu, Xu, Xu, Xu, Xu, Xu, Xu, Xu, Xu, Xu, Xu, Xu, Xu, Xu, Xu, Xu, Xu, Xu, Xu, Xu, Xu, Xu, Xu, Xu, Xu, Xu, Xu, Xu, Xu
Xu, Xu, Xu, Xu, Xu, Xu, Xu, Xu, Xu, Xu, Xu, Xu, Xu, Xu, Xu, Xu, Xu, Xu, Xu, Xu, Xu, Xu, Xu, Xu, Xu, Xu, Xu, Xu, Xu, Xu, Xu, Xu, Xu, Xu, Xu, Xu, Xu, Xu, Xu, Xu, Xu, Xu, Xu, Xu, Xu, Xu, Xu
Xu, Xu, Xu, Xu, Xu, Xu, Xu, Xu, Xu, Xu, Xu, Xu, Xu, Xu, Xu, Xu, Xu, Xu, Xu, Xu, Xu, Xu, Xu, Xu, Xu, Xu, Xu, Xu, Xu, Xu, Xu, Xu, Xu, Xu, Xu, Xu, Xu, Xu, Xu, Xu, Xu, Xu, Xu, Xu, Xu, Xu, Xu
Xu, Xu, Xu, Xu, Xu, Xu, Xu, Xu, Xu, Xu, Xu, Xu, Xu, Xu, Xu, Xu, Xu, Xu, Xu, Xu, Xu, Xu, Xu, Xu, Xu, Xu, Xu, Xu, Xu, Xu, Xu, Xu, Xu, Xu, Xu, Xu, Xu, Xu, Xu, Xu, Xu, Xu, Xu, Xu, Xu, Xu, Xu
Xu, Xu, Xu, Xu, Xu, Xu, Xu, Xu, Xu, Xu, Xu, Xu, Xu, Xu, Xu, Xu, Xu, Xu, Xu, Xu, Xu, Xu, Xu, Xu, Xu, Xu, Xu, Xu, Xu, Xu, Xu, Xu, Xu, Xu, Xu, Xu, Xu, Xu, Xu, Xu, Xu, Xu, Xu, Xu, Xu, Xu, Xu
Xu, Xu, Xu, Xu, Xu, Xu, Xu, Xu, Xu, Xu, Xu, Xu, Xu, Xu, Xu, Xu, Xu, Xu, Xu, Xu, Qxu, Xu, Xu, Xu, Xu, Xu, Xu, Xu, Xu, Xu, Xu, Xu, Xu, Xu, Xu, Xu, Xu, Xu, Xu, Xu, Xu, Xu, Xu, Xu, Xu, Xu, Xu
Xu, Xu, Xu, Xu, Xu, Xu, Xu, Xu, Xu, Xu, Xu, Xu, Xu, Xu, Xu, Xu, Uu, Qxu, Qxu, Qxu, Qxu, Qxu, Uu, Uu, Uu, Xu, Xu, Xu, Xu, Xu, Xu, Xu, Xu, Xu, Xu, Xu, Xu, Xu, Xu, Xu, Uu, Chr, Chr, Chr, 4 Khr, Chr, Uu
Xu, Xu, Xu, Xu, Xu, Xu, Xu, Xu, Xu, Xu, Xu, Xu, Xu, Xu, Chr, Uu, Uu, Uu, Uu, Qxu, Uu, Uu, Uu, Uu, Uu, Uu, Uu, Xu, Uu, Xu, Xu, Xu, Xu, Xu, Xu, Xu, Qxu, Xu, Uu, Uu, Uu, Chr, Uu, Chr, Uh, Chr, Uh
Xu, Xu, Xu, Xu, Xu, Xu, Xu, Xu, Xu, Xu, Xu, Xu, Chr, Chr, Chr, Uu, Tb^Tf, Uu, Uu, Uu, Uu, Uu, Uu, Uu, Uh, Uh, Uh, Uhe, Uhe, Uu, Uu, Uu, Uu, Xu, Qxu, Qxu, Qxu, Uu, Uu, Uu, Uh, Uh, Uh, Uh, Uh, Uu, Uh
Uu^Ii, Xu, Uu^Ii, Xu, Uu^Ii, Xu, Uu^Ii, Xu, Uu, Xu, Uu, Uu, Uu, Chr, Tb^Tf, Tb^Tf, Uu, Tb^Tf, Uh, Uh, Chr, Uu, Uh, Uh, Uh, Uh, Uu, Uhe, Uhe, Uu, Uhe, Uu, Uh, Uh, Uh, Uh, Uh, Uh, Uh, Uh, Uh, Uh, Uh, Uu, Uu, Uh, Uh
Uu^Ii, Uu^Ii, Uu^Ii, Uu^Ii, Uu^Ii, Uu^Ii, Uu^Ii, Uu, Uu, Uu, Uu, Uu, Tb^Tf, Tb^Tf, Uu, Uu, Uu, Uu, Uh, Uh, Chr, Chr, Uh, Uh, Uu, Uh, Tb^Tf, Uu, Tb^Tf, Uhe, Uhe, Uh, Uh, Uh, Uh, Uh, Uh, Uu, Uu, Uh, Uu, Uh, Uu, Uh, Uh, Uh, Uh
Uu^Ii, Uu^Ii, Uu^Ii, Uu^Ii, Uu^Ii, Uu^Ii, Uu^Ii, Tb^Tf, Uu, Uu, Tb^Tf, Tb^Tf, Tb^Tf, Uu, Uu, Uu, Uu, Uu, Uh, Uu, Uu, Uh, Uh, Uu, Uu, Uh, Uu, Tb^Tf, Uu, Tb^Tf, Tb^Tf, Uu, Uu, Uh, Uu, Uh, Uu, Uh, Uh, Uh, Uu, Uu, Uu, Uh, Uh, Uh, Uu
Uu^Ii, Uu^Ii, Uu^Ii, Uu^Ii, Uu^Ii, Uu^Ii, Uu^Ii, Tb^Tf, Tb^Tf, Tb^Tf, Uu, Tb^Tf, Uu, Uu, Uu, Uu, Uu, Uu, Uh, Uu, Uu, Uh, Uh, Uh, Uh, Uh, Uh, Uu, Uu, Uu, Uu, Tb^Tf, Tb^Tf, Uh, Uh, Uu, Uu, Uu, Uh, Uh, Uhe, Uu, Uu, Uh, Uu, Uu, Uu
Uu^Ii, Uu^Ii, Uu^Ii, Uu^Ii, Uu^Ii, Uu^Ii, Uu^Ii, Uu, Uu, Uu, Uu, Uu, Uu, Uu, Uu, Uhe, Uhe, Uu, Uh, Uh, Uh, Uh, Uu, Uu, Uu, Uh, Uh, Uu, Uu, Uu, Uu, Uu, Tb^Tf, Tb^Tf, Tb^Tf, Uu, Uu, Uu, Uu, Uu, Uu, Uhe, Uu, Uu, Uhe, Uhe, Uhe
Uu^Ii, Uu^Ii, Uu^Ii, Uu^Ii, Uu^Ii, Uu^Ii, Uu^Ii, Uu, Uu, Uu, Uu, Uu, Uu, Uu, Uu, Uu, Uu, Uhe, Uhe, Chr, Uhe, Uh, Uh, Chr, Uu, Uh, Uu, Uu, Uhe, Uhe, Uu, Uu, Tb^Tf, Tb^Tf, Tb^Tf, Tb^Tf, Tb^Tf, Uu, Uu, Uu, Uu, Uhe, Uhe, Uu, Uhe, Uhe, Uhe
Uu^Ii, Uu^Ii, Uu^Ii, Uu^Ii, Uu^Ii, Uu^Ii, Uu^Ii, Uu, Uu, Uu, Uu, Uu, Uu, Uu, Uu, Uu, Uu, Uu, Uu, Uhe, Uhe, Uhe, Uu, Uh, Uu, Uu, Uhe, Uhe, Uu, Uu, Ch, Tb^Tf, Tb^Tf, Tb^Tf, Tb^Tf, Uu, Uu, Tb^Tf, Uu, Uu, Uu, Uu, Uu, Uhe, Uu, Uu, Uhe
Uu^Ii, 6 Uu^Ii, Uu^Ii, Uu^Ii, Uu^Ii, Uu^Ii, Uu^Ii, Uu, Uu, Uu, Uu, Uu, Uu, Uu, Uu, Uu, Uu, Uu, Uu, Tb^Tf, Tb^Tf, Uu, Uu, Uu, Uu, Uhe, Uhe, Uhe, Uhe, 5 Khr, Chr, Uu, Uhe, Uu, Uu, Uu, Uu, Uu, Uu, Uu, Uu, Uu, Uu, Uu, Uu, Uu, Uu
Uu^Ii, Uu^Ii, Uu^Ii, Uu^Ii, Uu^Ii, Uu^Ii, Uu^Ii, Uu, Uu, Uu, Uhe, Uu, Uu, Uu, Uu, Uu, Uu, Uu, Uu, Uu, Uu, Tb^Tf, Uu, Uu, Uu, Uhe, Chr, Uhe, Uhe, Chr, Chr, Uhe, Uu, Uhe, Uu, Uhe, Uhe, Uu, Uh, Uh, Uh, Uu, Uu, Uu, Uu, Chr, Uu
Uu^Ii, Uu^Ii, Uu^Ii, Uu^Ii, Uu^Ii, Uu^Ii, Uu^Ii, Uu, Uu, Uhe, Uu, Uhe, Uhe, Uu, Uu, Uu, Uu, Uu, Uu, Uu, Uu, Tb^Tf, Tb^Tf, Uu, Uhe, Uhe, Chr, Uhe, Chr, Chr, Uhe, Uhe, Uhe, Uu, Uu, Uu, Uu, Uhe, Uu, Uu, Uu, Uh, Uu, Uu, Uh, Chr, Uh
Uu^Ii, Uu^Ii, Uu^Ii, Uu^Ii, 1 Uu^Ii, Uu^Ii, Uu^Ii, Uu, Uu, Uu, Uu, Uu, Uh, Uh, Uh, Uu, Uu, Uu, Uu, Uu, Uu, Uu, Tb^Tf, Tb^Tf, Uu, Uhe, Chr, Uhe, Uhe, Chr, Uhe, Uhe, Uhe, Uhe, Uhe, Uhe, Uhe, Uhe, Uu, Uu, Uu, Uu, Uu, Uu, 3 Khr, Chr, Chr
Uu^Ii, Uu^Ii, Uu^Ii, Uu^Ii, Uu^Ii, Uu^Ii, Uu^Ii, Uu, Uu, Uu, Uu, Uu, Uu, Uh, Uh, Uh, Uu, Uu, Uu, Uu, Uu, Uu, Uu, Tb^Tf, Uu, Uhe, Uhe, Uhe, Uu, Uhe, Uhe, Uhe, Uhe, Uhe, Uhe, Uu, Uh, Uh, Uh, Uu, Uh, Uu, Uu, Uu, Chr, Chr, Chr
Uu^Ii, Uu^Ii, Uu^Ii, Uu^Ii, Uu^Ii, Uu^Ii, Uu^Ii, Uu, Uu, Uu, Uu, Uu, Uu, Uu, Uu, Uh, Uh, Uh, Uh, Uu, Uu, Uu, Tb^Tf, Uu, Uu, Uu, Uu, Uu, Uu, Uu, Uhe, Uhe, Uhe, Uhe, Uu, Uu, Uu, Uh, Uh, Uu, Uh, Uu, Uh, Uh, Chr, Chr, Uh
Uu^Ii, Uu^Ii, Uu^Ii, Uu^Ii, Uu^Ii, Uu^Ii, Uu^Ii, Uu, Uu, Uu, Uu, Uu, Uu, Uu, Uu, Uu, Uhe, Uu, Uu, Uu, Uu, Uu, Uu, Tb^Tf, Tb^Tf, Tb^Tf, Uu, Uu, Tb^Tf, Uu, Uu, Uu, Uu, Uu, Tb^Tf, Uu, Uu, Uu, Uhe, Uu, Uhe, Uh, Uu, Uh, Uh, Uh, Uu
Uu^Ii, Uu^Ii, Uu^Ii, Uu^Ii, Uu^Ii, Uu^Ii, Uu^Ii, Uu, Uu, Uu, Uu, Uu, Uu, Uu, Uhe, Uhe, Uu, Uu, Uu, Uu, Uu, Uu, Uu, Uu, Tb^Tf, Tb^Tf, Tb^Tf, Tb^Tf, Tb^Tf, Tb^Tf, Tb^Tf, Tb^Tf, Tb^Tf, Tb^Tf, Tb^Tf, Uu, Uu, Uu, Uu, Uhe, Uu, Uhe, Uhe, Uhe, Uhe, Uu, Uu
Uu^Ii, Uu^Ii, Uu^Ii, Uu^Ii, Uu^Ii, Uu^Ii, Uu^Ii, Uu, Uu, Uu, Uu, Uu, Chr, Uu, Uhe, Uhe, Uu, Uu, Uu, Uu, Uu, Uu, Uhe, Uu, Uu, Uu, Uu, Uu, Uu, Uu, Uu, Tb^Tf, Uu, Tb^Tf, Tb^Tf, Tb^Tf, Uhe, Uu, Uu, Uu, Uu, Uu, Uh, Uhe, Uh, Uhe, Uhe
Uu^Ii, Uu^Ii, Uu^Ii, Uu^Ii, Uu^Ii, Uu^Ii, Uu^Ii, Uu, Uu, Uu, Xu, Khr, Uhe, Uhe, Tb^Tf, Tb^Tf, Tb^Tf, Tb^Tf, Tb^Tf, Uu, Uu, Uu, Uu, Uhe, Uhe, Uu, Uhe, Uu, Uhe, Uu, Uhe, Uu, Uhe, Uu, Uhe, Uhe, Uu, Uu, Uu, Uu, Uu, Uh, Uhe, Uh, Uh, Uh, Uh
Xu, Uu^Ii, Xu, Uu^Ii, Xu, Uu^Ii, Xu, Uu, Xu, Xu, Xu, Xu, Xu, Uu, Tb^Tf, Tb^Tf, Tb^Tf, Tb^Tf, Tb^Tf, Uu, Uu, Uhe, Uh, Uu, Uhe, Uhe, Uu, Uhe, Uu, Uhe, Uhe, Uhe, Uhe, Uhe, Uu, Uh, Uh, Uh, Uu, Uu, Uu, Uu, Uhe, Uu, Uu, Uu, Uu
Xu, Xu, Xu, Xu, Xu, Xu, Xu, Xu, Xu, Xu, Xu, Xu, Xu, Xu, Tb^Tf, Tb^Tf, Tb^Tf, Tb^Tf, Tb^Tf, Uu, Uu, Uu, Uh, Uh, Uh, Uh, Uu, Uh, Uh, Uu, Uu, Uhe, Uhe, Uu, Uu, Uh, Uu, Uh, Uh, Uh, Uu, Uu, Uu, Uhe, Uhe, Uu, Uu
Xu, Xu, Xu, Xu, Xu, Xu, Xu, Xu, Xu, Xu, Xu, Xu, Xu, Xu, Qxu, Tb^Tf, Uu, Tb^Tf, Uu, Uu, Uu, Uu, Uh, Uh, Uu, Uu, Uu, Uu, Uh, Uh, Uu, Uhe, Uh, Uh, Uu, Uu, Xu, Uh, Uh, Uh, Uh, Uu, Uu, Uu, Uh, Uh, Uh
Xu, Xu, Xu, Xu, Xu, Xu, Xu, Xu, Xu, Xu, Xu, Xu, Xu, Xu, Xu, Qxu, Uu, Uu, Uu, Uu, Uh, Uu, Uh, Uu, Uh, Uu, Uu, Uh, Tb^Tf, Uh, Tb^Tf, Tb^Tf, Tb^Tf, Uh, Xu, Xu, Xu, Uu, Uu, Uh, Uu, Uu, Xu, Xu, Xu, Uu, Uh
Xu, Xu, Xu, Xu, Xu, Xu, Xu, Xu, Xu, Xu, Xu, Xu, Xu, Xu, Xu, Qxu, Qxu, Uu, Uu, Tb^Tf, Tb^Tf, Uu, Uhe, Uhe, Uhe, Uhe, Uhe, Uhe, Uu, Tb^Tf, Uu, Tb^Tf, Xu, Xu, Xu, Xu, Tb^Tf, Uu, Tb^Tf, Tb^Tf, Tb^Tf, Xu, Xu, Xu, Xu, Xu, Xu
Xu, Xu, Xu, Xu, Xu, Xu, Xu, Xu, Xu, Xu, Xu, Xu, Xu, Xu, Xu, Xu, Qxu, Qxu, Qxu, Uu, Uu, Tb^Tf, Tb^Tf, Uhe, Uu, Uhe, Uu, Uhe, Uu, Uu, Xu, Xu, Xu, Xu, Uu, Uu, Uu, Tb^Tf, Uu, Uu, Uu, Uu, Uu, Xu, Xu, Xu, Xu
Xu, Xu, Xu, Xu, Xu, Xu, Xu, Xu, Xu, Xu, Xu, Xu, Xu, Xu, Xu, Xu, Xu, Qxu, Qxu, Qxu, Xu, Xu, Xu, Uu, Xu, Xu, Xu, Xu, Xu, Xu, Xu, Xu, Xu, Uu, Uu, Uu, Uu, Uu, Cud, Cud, Cud, Uu, Uu, Uu, Uu, Xu, Xu
Xu, Xu, Xu, Xu, Xu, Xu, Xu, Xu, Xu, Xu, Xu, Xu, Xu, Xu, Xu, Xu, Xu, Xu, Xu, Xu, Xu, Xu, Xu, Xu, Xu, Xu, Xu, Xu, Xu, Xu, Xu, Xu, Xu, Uu, Uu, Uu, Uu, Cud, Cud, 2 Kud, Cud, Cud, Uu, Uu, Uu, Uu, Xu
Xu, Xu, Xu, Xu, Xu, Xu, Xu, Xu, Xu, Xu, Xu, Xu, Xu, Xu, Xu, Xu, Xu, Xu, Xu, Xu, Xu, Xu, Xu, Xu, Xu, Xu, Xu, Xu, Xu, Xu, Xu, Xu, Xu, Uu, Uu, Uu, Uu, Cud, Cud, Cud, Uu, Uu, Uu, Uu, Uu, Uu, Uu
Xu, Xu, Xu, Xu, Xu, Xu, Xu, Xu, Xu, Xu, Xu, Xu, Xu, Xu, Xu, Xu, Xu, Xu, Xu, Xu, Xu, Xu, Xu, Xu, Xu, Xu, Xu, Xu, Xu, Xu, Xu, Xu, Xu, Uu, Uu, Uu, Uu, Uu, Uu, Uu, Uu, Uu, Uu, Uu, Uu^Vud, Uu, Uu^Vud
