Xu, Xu, Uu, Xu, Xu, Xu, Xu, Uu, Xu, Xu, Xu, Xu, Uu, Uu, Xu, Xu, Xu, Xu, Uu, Xu, Xu, Xu, Xu, Xu, Xu, Xu, Uu, Xu, Xu, Xu, Uu, Xu, Xu, Xu, Uu, Xu, Xu, Xu, Xu, Uu, Xu, Uu
Xu, Xu, Uu, Xu, Xu, Xu, Xu, Uu, Xu, Xu, Xu, Xu, Xu, Uu, Uu, Xu, Xu, Xu, Xu, Uu, Xu, Xu, Xu, Xu, Xu, Uu, Uu, Xu, Xu, Xu, Uu, Xu, Xu, Xu, Uu, Xu, Xu, Xu, Uu, Uu, Xu, Xu
Xu, Xu, Uu, Xu, Xu, Xu, Xu, Uu, Xu, Xu, Xu, Xu, Xu, Xu, Xu, Uu, Uu, Uu, Uu, Uu, Xu, Xu, Xu, Xu, Xu, Uu, Uu, Uu, Uu, Uu, Xu, Xu, Xu, Xu, Uu, Xu, Xu, Xu, Uu, Xu, Xu, Xu
Xu, Xu, Xu, Uu, Uu, Xu, Uu, Uu, Xu, Xu, Xu, Xu, Xu, Xu, Xu, Xu, Xu, Uu, Xu, Uu, Xu, Xu, Xu, Xu, Xos, Uu, Xu, Xu, Xu, Xu, Xu, Xu, Xu, Xu, Uu, Xu, Xu, Xu, Uu, Xu, Uu, Uu
Xu, Xu, Xu, Xu, Xu, Uu, Xu, Uu, Uu, Xu, Xu, Xu, Xu, Xu, Xu, Xu, Xos, Xos, Xom, Uu, Xom, Xu, Xom, Xom, Xom, Uu, Xom, Xu, Xom, Xu, Xom, Xu, Xom, Xom, Uu, Xu, Xu, Uu, Xu, Xu, Uu, Xu
Xu, Xu, Xu, Xu, Xu, Uu, Xu, Xu, Xu, Uu, Uu, Xu, Uu, Xom, Xom, Xom, Xom, Xom, Uu, Uu, Uh, Xom, Uu, Uu^Vud, Uu, Uu, Uu, Xom, Uu, Xom, Uu, Xom, Uu, Uh, Uu, Uu, Uu, Uu, Uu, Uu, Xu, Xu
Xu, Xu, Xu, Xu, Xu, Uu, Xu, Xu, Xom, Xu, Xu, Uu, Uu, Uh, Uh, Uh, Uh, Uu, Uh, Uh, Uh, Uh, Uh, Uh, Uh, Uu, Uu, Uu, Uu, Uu, Uh, Uu, Uh, Uh, Xom, Xu, Xu, Xu, Xu, Uu, Uu, Uu
Xu, Xu, Xu, Xu, Xu, Uu, Uu, Uu, Uu, Xom, Xom, Xom, Uh, Uh, Uu^Vud, Uu, Uh, Uu, Uh, Uh, Uh, Uh, Uu^Vud, Uh, Uh, Uh, Uu, Uh, Uh, Uh, Uh, Uh, Uh, Uu, Uu, Xom, Xu, Xu, Xu, Xu, Xu, Xu
Xu, Xu, Xu, Xu, Xu, Uu, Xu, Xu, Xu, Uu, Uh, Uh, Uu, Uh, Uh, Uh, Uh, Uu, Uh, Uh, Uu, Uh, Uh, Uh, Uh, Uu, Uu, Uu, Uh, Uh, Uh, Uu^Vud, Uh, Uh, Uu, Xom, Xu, Xu, Xu, Xu, Xu, Xu
Xu, Xu, Xu, Xu, Xu, Xu, Xu, Xu, Xu, Xom, Uu, Uh, Uu, Uh, Uh, Uh, Uu, Uu, Uh, Uh, Uh, Uh, Uu, Uh, Uu, Uu, Uu, Uu^Vud, Uu, Uh, Uh, Uh, Uh, Uh, Uu, Xom, Xu, Xu, Xu, Xu, Xu, Xu
Xu, Xu, Xu, Xu, Xu, Xu, Xu, Xu, Xu, Xom, Uu, Uu, Uu, Uu, Uh, Uh, Uu, Uh, Uu, Uu, Uu, Uh, Uu, Uh, Uh, Uh, Uu, Uu, Uu, Uu, Uh, Uh, Uu, Uu, Uu, Xom, Xu, Xu, Xu, Xu, Xu, Xu
Xu, Xu, Xu, Xu, Xu, Xu, Xu, Xu, Xom, Xom, Uu, Uu, Uu^Vud, Uh, Uu, Uh, Uh, Uu^Vud, Uu, Uu, Uu, Uu, Ce, Uu, Uu, Uh, Uh, Uu, Uh, Uu, Uh, Uu, Uu, Uu, Uu, Xom, Xom, Xu, Xu, Xu, Xu, Xu
Uu, Xu, Uu, Xu, Uu, Uu, Uu, Uu, Uu, Uu, Uu, Uu, Uu, Uh, Uu, Uu, Uu, Uh, Uh, Uu, Ce, Ce, 1 Ke, Ce, Uu, Uu, Uh, Uu, Uu, Uh, Uu, Uu, Uu, Uu, Uu, Uu, Uu, Xu, Xu, Xu, Uu, Uu
Uu, Uu, Xu, Uu, Xu, Xu, Xu, Xu, Xu, Xom, Uu, Uu, Uu, Uh, Uu, Uu, Uu, Uu, Uu, Uu, Uu, Ce, Ce, Ce, Uh, Uh, Uh, Uu, Uu, Uu, Uu, Uu, Uu, Uu, Uu, Xom, Xom, Uu, Xu, Uu, Uu, Xu
Uu, Uu, Uu, Xu, Xu, Xu, Xu, Xu, Xu, Xom, Uu, Uu, Uu, Uh, Uu, Uu, Uu, Uu, Uu, Uu, Uu, Uu, Uu, Uu, Uh, Uh, Uu, Uu^Vud, Uu, Uh, Uh, Uh, Uh, Uu, Uu, Xom, Xom, Uu, Uu, Uu, Xu, Xu
Xu, Xu, Xu, Uu, Uu, Xu, Uu, Xu, Xu, Xom, Uu, Uu, Uu, Uu, Uu, Uu, Uh, Uu^Vud, Uh, Uh, Uh, Uu, Uu, Uh, Uu, Uh, Uh, Uu, Uh, Uh, Uu, Uu^Vud, Uu, Uu, Uh, Xom, Xu, Xu, Xu, Uu, Xu, Xu
Xu, Xu, Xu, Xu, Xu, Uu, Xu, Uu, Uu, Xom, Uu, Uu, Uu, Uu^Vud, Uu, Uh, Uu, Uh, Uh, Uu, Uu, Uh, Uu, Uh, Uu, Uu, Uh, Uu, Uh, Uu, Uu, Uu, Uu, Uu, Uu, Xom, Xu, Xu, Xu, Xu, Xu, Xu
Xu, Xu, Xu, Xu, Xu, Xu, Xu, Xu, Xu, Uu, Uu, Uu, Uh, Uh, Uh, Uu, Uh, Uh, Uu, Uu, Uu, Uh, Uu^Vud, Uh, Uu, Uu, Uh, Uu, Uh, Uh, Uu, Uu, Uu, Uu, Uu, Xom, Xu, Xu, Xu, Xu, Xu, Xu
Xu, Xu, Xu, Xu, Xu, Xu, Xu, Xu, Xu, Xom, Uu, Uu, Uh, Uu, Uh, Uu, Uh, Uu^Vud, Uh, Uu, Uh, Uh, Uu, Uh, Uh, Uu, Uh, Uh, Uh, Uh, Uu, Uh, Uu, Uh, Uh, Xom, Xos, Xu, Xu, Xu, Xu, Xu
Xu, Xu, Xu, Xu, Xu, Xu, Xu, Xu, Xu, Xom, Uu, Uh, Uu, Uu, Uh, Uu, Uh, Uu, Uh, Uu, Uu, Uu, Uu, Uu, Uh, Uh, Uh, Uu, Uu, Uh, Uu^Vud, Uu, Uh, Uu, Uu, Xom, Xom, Xu, Xu, Xu, Xu, Xu
Xu, Xu, Xu, Xu, Xu, Xu, Xu, Xu, Xu, Xom, Uu, Uh, Uh, Uu, Uh, Uh, Uu, Uu, Xom, Xom, Uu, Xom, Xom, Uu, Uu^Vud, Uu, Uh, Uu, Uh, Uu, Uh, Uh, Uh, Uh, Uu, Uu, Uu, Xu, Xu, Xu, Xu, Xu
Xu, Xu, Uu, Xu, Xu, Xu, Xu, Xu, Xu, Xu, Xom, Uh, Uh, Uh, Uh, Uu, Xom, Xom, Xom, Xom, Uu, Xu, Xu, Xom, Xom, Uu, Uu, Uh, Uu, Uu, Uu, Uu, Uh, Uh, Xom, Xom, Xom, Uu, Uu, Xu, Uu, Xu
Uu, Uu, Xu, Uu, Uu, Uu, Uu, Xu, Xu, Xom, Uu, Uu, Xom, Uh, Xom, Xom, Xu, Xu, Xu, Xu, Uu, Xu, Xu, Xu, Xu, Xom, Xom, Uh, Uu, Uu, Uu, Uh, Xom, Xom, Xu, Xu, Xu, Xu, Uu, Uu, Xu, Uu
Xu, Xu, Xu, Xu, Xu, Xu, Xu, Uu, Uu, Uu, Xu, Xu, Xu, Xu, Xu, Xu, Xu, Xu, Xu, Xu, Uu, Xu, Xu, Xu, Xu, Xu, Xu, Xom, Xom, Uu, Uu, Xom, Xom, Xu, Xu, Xu, Xu, Uu, Xu, Xu, Xu, Xu
Xu, Xu, Xu, Xu, Xu, Xu, Uu, Uu, Uu, Xu, Uu, Xu, Xu, Xu, Xu, Xu, Xu, Xu, Xu, Xu, Uu, Xu, Xu, Xu, Xu, Xu, Xu, Xu, Xu, Xom, Xom, Uu, Uu, Xu, Xu, Xu, Xu, Uu, Xu, Xu, Xu, Xu
Xu, Xu, Xu, Xu, Xu, Xu, Uu, Uu, Xu, Uu, Uu, Xu, Xu, Xu, Xu, Xu, Xu, Xu, Xu, Xu, Uu, Xu, Uu, Xu, Xu, Xu, Xu, Xu, Xu, Xu, Xu, Xu, Uu, Xu, Xu, Xu, Uu, Uu, Xu, Xu, Xu, Xu
Xu, Xu, Xu, Xu, Uu, Uu, Xu, Uu, Xu, Xu, Xu, Uu, Uu, Xu, Xu, Xu, Xu, Xu, Uu, Uu, Xu, Uu, Uu, Uu, Uu, Xu, Xu, Xu, Xu, Xu, Xu, Xu, Uu, Xu, Xu, Xu, Uu, Xu, Xu, Xu, Xu, Xu
Xu, Xu, Uu, Uu, Xu, Xu, Xu, Uu, Uu, Xu, Xu, Xu, Uu, Xu, Xu, Xu, Xu, Xu, Uu, Xu, Xu, Xu, Uu, Uu, Xu, Uu, Uu, Xu, Xu, Xu, Xu, Xu, Uu, Uu, Uu, Xu, Uu, Xu, Xu, Xu, Xu, Xu
Uu, Uu, Xu, Xu, Xu, Xu, Uu, Uu, Uu, Xu, Xu, Xu, Xu, Uu, Xu, Xu, Xu, Xu, Uu, Xu, Uu, Uu, Uu, Xu, Xu, Xu, Uu, Xu, Xu, Xu, Xu, Xu, Uu, Xu, Xu, Uu, Uu, Uu, Uu, Xu, Xu, Xu
Uu, Xu, Xu, Xu, Uu, Uu, Xu, Xu, Uu, Xu, Xu, Xu, Xu, Uu, Xu, Xu, Xu, Xu, Uu, Uu, Xu, Xu, Uu, Xu, Uu, Uu, Uu, Uu, Xu, Xu, Xu, Xu, Uu, Xu, Xu, Xu, Xu, Xu, Xu, Uu, Uu, Xu
Xu, Xu, Uu, Uu, Xu, Xu, Xu, Xu, Uu, Uu, Xu, Xu, Xu, Uu, Xu, Xu, Xu, Xu, Uu, Xu, Xu, Xu, Uu, Uu, Xu, Xu, Uu, Uu, Xu, Xu, Xu, Xu, Uu, Xu, Xu, Xu, Xu, Xu, Xu, Xu, Uu, Xu
Uu, Uu, Xu, Xu, Xu, Xu, Xu, Xu, Uu, Uu, Xu, Xu, Xu, Uu, Xu, Xu, Xu, Xu, Uu, Uu, Uu, Uu, Uu, Uu, Uu, Uu, Uu, Xu, Xu, Xu, Xu, Xu, Uu, Xu, Xu, Xu, Xu, Xu, Xu, Xu, Uu, Xu
