Uu, Uu, Uu, Uu, Uu, Uu, Uu, Uu, Uu, Uu, Uu, Uu, Uu, Uu, Uu, Uu, Uu, Uu, Uu, Uu, Uu, Uu, Uu, Uu, Uu, Uu, Uu, Uu, Uu
Uu, Uu, Uu, Uu, Uu, Uu, Uu, Uu, Uu, Uu, Uu, Uu, Uu, Uu, Uu, Uu, Uu, Tb^Tf, Tb^Tf, Tb^Tf, Uh, Uh, Uh, Uu, Uu, Uu, Uu, Uu, Uu
Uu, Uu, Uu^Vud, Uu, Uu, Uu, Uu, Uu, Uu, Uu^Vud, Uu, Uu, Uu^Emf, Uu, Uu, Uu, Uu^Vud, Tb^Tf, Tb^Tf, Tb^Tf, Uh, Uh, Uh, Uu, Uu, Uu^Emf, Uu^Emf, Uu^Emf, Uu
Uu, Uu, Tb^Tf, Uu, Uu, Uu^Vud, Uu, Uh, Uh, Uu, Uu, Uu, Uu^Emf, Uu^Emf, Uu, Uu, Uu, Tb^Tf, Tb^Tf, Uh, Uh, Uh, Uh, Uu^Vud, Uu, Uu^Emf, Uu^Emf, Uu, Uu
Uu, Uu, Tb^Tf, Tb^Tf, Tb^Tf, Uu, Uu, Uh, Uh, Uh, Uh, Uu, Uu^Vud, Uu, Uu, Uu, Uu, Uu, Uu, Uh, Uu, Uh, Uu, Uu, Uu, Uu^Vud, Uh, Uu, Uu
Uu, Uu, Tb^Tf, Tb^Tf, Tb^Tf, Uu, Uu, Uu, Tb^Tf, Uh, Uu, Uu, Uu, Uu, Uh, Uh, Cud, Uu, Uu, Uu, Uu, Uu, Uu, Uu, Uh, Uh, Uh, Uh, Uh
Uu, Uu, Uu, Tb^Tf, Uh, Uu, Uu^Vud, Tb^Tf, Tb^Tf, Tb^Tf, Tb^Tf, Uu, Ur^Br\, Uu, Cud, Cud, Cud, Cud, Cud, Uu, Uu, Uu, Uu, Uh, Uh, Uh, Uh, Uh, Uu
Uu, Uu, Uu^Vud, Uu, Uh, Uh, Uh, Tb^Tf, Tb^Tf, Tb^Tf, Ur^Br/, Ur^Br/, Uu, Ur^Br\, Cud, Cud, 2 Kud, Cud, 1 Cud, Ur^Br\, Ur^Br\, Uu^Vud, Ur^Br/, Ur^Br\, Ur^Br\, Uh, Uu, Uu, Uu
Ur^Br\, Uu, Ur^Br\, Uh, Uh, Uh, Uh, Uu, Ur^Br/, Ur^Br/, Uh, Uh, Uh, Uu, Cud, Cud, Cud, Cud, Cud, Uu, Ur^Br/, Ur^Br/, Ur^Br\, Uu, Uu, Ur^Br\, Ur^Br\, Uu, Uu
Tb^Tf, Ur^Br/, Tb^Tf, Ur^Br\, Ur^Br\, Uh, Ur^Br/, Ur^Br/, Uu, Uu, Uh, Uh, Uh, Uu, Uu, Cud, Cud, Cud, Ur^Br/, Ur^Br/, Uu, Uu, Uu, Ur^Br\, Ur^Br\, Uu, Uu, Ur^Br\, Ur^Br\
Tb^Tf, Tb^Tf, Tb^Tf, Tb^Tf, Uu, Ur^Br/, Uu, Uu, Uu, Uu, Uh, Uh, Uu, Uu, Uu, Uu, Ur^Br/, Ur^Br/, Uu, Uu, Uu, Uu, Uu, Uu, Uu, Ur^Br\, Ur^Br\, Uu, Uu
Tb^Tf, Tb^Tf, Tb^Tf, Tb^Tf, Uh, Uh, Uh, Uu^Vud, Uu, Uu, Uu, Uu, Uu, Uu, Ur^Br/, Ur^Br/, Uu, Uu, Uu, Uu, Uh, Uh, Uu, Uu, Tb^Tf, Uh, Uh, Ur^Br\, Ur^Br\
Tb^Tf, Tb^Tf, Tb^Tf, Uu, Uh, Uh, Uh, Uu, Uu, Uu, Uu, Uu, Ur^Br/, Ur^Br/, Uu, Uu, Uu, Uu, Uu, Uh, Uh, Uu, Uu, Tb^Tf, Tb^Tf, Tb^Tf, Uu, Uh, Uh
Uu, Uu, Uu, Uu, Uu, Uh, Uh, Uh, Uu, Uu, Ur^Br/, Ur^Br/, Uu, Uu, Uu, Uu, Uu, Uu, Uu, Uu, Uu, Uu, Tb^Tf, Tb^Tf, Tb^Tf, Uu, Uu, Uh, Uh
Uu, Uu, Uu, Uu, Uu, Uu, Uu, Uu, Ur^Br/, Ur^Br/, Uu, Uu, Uu, Uu, Uu, Uu, Uh, Uu^Emf, Uu^Emf, Uu, Uh, Uu^Vud, Tb^Tf, Tb^Tf, Tb^Tf, Uu, Uu, Uu^Vud, Uu
Uh, Uh, Uh, Uu^Vud, Uu, Uu, Ur^Br/, Ur^Br/, Uu, Uu, Uu, Uu, Uu^Vud, Uu, Uh, Uh, Uh, Uh, Uu^Emf, Uh, Uh, Uh, Uh, Tb^Tf, Uu, Uu, Uu, Uu, Uu
Uh, Uh, Uh, Uu, Ur^Br/, Ur^Br/, Uu, Uu, Uu, Uu, Uu, Uu, Uu, Uh, Uh, Uh, Uu, Uu^Vud, Uu, Uu, Uu, Uh, Uh, Uu, Uu, Uu, Uu, Uu, Uu
Uu, Uh, Ur^Br/, Ur^Br/, Uu, Uu, Uu, Uu, Uu, Uu, Uu, Uu, Uu, Uu, Uu, Uu, Uu, Uu, Uu, Uu, Uu, Uu, Uu, Uu, Uu, Uu, Uu, Uu, Uu
