Xu, Xu, Uu, Xu, Xu, Xu, Xu, Uu, Xu, Xu, Xu, Xu, Uu, Uu, Xu, Xu, Xu, Xu, Uu, Xu, Xu, Xu, Xu, Xu, Xu, Xu, Uu, Xu, Xu, Xu, Uu, Xu, Xu, Xu, Uu, Xu, Xu, Xu, Xu, Uu, Xu, Uu
Xu, Xu, Uu, Xu, Xu, Xu, Xu, Uu, Xu, Xu, Xu, Xu, Xu, Uu, Uu, Xu, Xu, Xu, Xu, Uu, Xu, Xu, Xu, Xu, Xu, Uu, Uu, Xu, Xu, Xu, Uu, Xu, Xu, Xu, Uu, Xu, Xu, Xu, Uu, Uu, Xu, Xu
Xu, Xu, Uu, Xu, Xu, Xu, Xu, Uu, Xu, Xu, Xu, Xu, Xu, Xu, Xu, Uu, Uu, Uu, Uu, Uu, Xu, Xu, Xu, Xu, Xu, Uu, Uu, Uu, Uu, Uu, Xu, Xu, Xu, Xu, Uu, Xu, Xu, Xu, Uu, Xu, Xu, Xu
Xu, Xu, Xu, Uu, Uu, Xu, Uu, Uu, Xu, Xu, Xu, Xu, Xu, Xu, Xu, Xu, Xu, Uu, Xu, Uu, Xu, Xu, Xu, Xu, Xos, Uu, Xu, Xu, Xu, Xu, Xu, Xu, Xu, Xu, Uu, Xu, Xu, Xu, Uu, Xu, Uu, Uu
Xu, Xu, Xu, Xu, Xu, Uu, Xu, Uu, Uu, Xu, Xu, Xu, Xu, Xu, Xu, Xu, Xos, Xos, Xor, Uu, Xor, Xu, Xor, Xor, Xor, Uu, Xor, Xu, Xor, Xu, Xor, Xu, Xor, Xor, Uu, Xu, Xu, Uu, Xu, Xu, Uu, Xu
Xu, Xu, Xu, Xu, Xu, Uu, Xu, Xu, Xu, Uu, Uu, Xu, Uu, Xor, Xor, Xor, Xor, Xor, Uu, Uu, Uh, Xor, Uu, Uu^Vud, Uu, Uu, Uu, Xor, Uu, Xor, Uu, Xor, Uu, Uh, Uu, Uu, Uu, Uu, Uu, Uu, Xu, Xu
Xu, Xu, Xu, Xu, Xu, Uu, Xu, Xu, Xor, Xu, Xu, Uu, Uu, Uh, Uh, Uh, Uh, Uu, Uh, Uh, Uh, Uh, Uh, Uh, Uh, Uu, Uu, Uu, Uu, Uu, Uh, Uu, Uh, Uh, Xor, Xu, Xu, Xu, Xu, Uu, Uu, Uu
Xu, Xu, Xu, Xu, Xu, Uu, Uu, Uu, Uu, Xor, Xor, Xor, Uh, Uh, Uu^Vud, Uu, Uh, Uu, Uh, Uh, Uh, Uh, Uu^Vud, Uh, Uh, Uh, Uu, Uh, Uh, Uh, Uh, Uh, Uh, Uu, Uu, Xor, Xu, Xu, Xu, Xu, Xu, Xu
Xu, Xu, Xu, Xu, Xu, Uu, Xu, Xu, Xu, Uu, Uh, Uh, Uu, Uh, Uh, Uh, Uh, Uu, Uh, Uh, Uu, Uh, Uh, Uh, Uh, Uu, Uu, Uu, Uh, Uh, Uh, Uu^Vud, Uh, Uh, Uu, Xor, Xu, Xu, Xu, Xu, Xu, Xu
Xu, Xu, Xu, Xu, Xu, Xu, Xu, Xu, Xu, Xor, Uu, Uh, Uu, Uh, Uh, Uh, Uu, Uu, Uh, Uh, Uh, Uh, Uu, Uh, Uu, Uu, Uu, Uu^Vud, Uu, Uh, Uh, Uh, Uh, Uh, Uu, Xor, Xu, Xu, Xu, Xu, Xu, Xu
Xu, Xu, Xu, Xu, Xu, Xu, Xu, Xu, Xu, Xor, Uu, Uu, Uu, Uu, Uh, Uh, Uu, Uh, Uu, Uu, Uu, Uh, Uu, Uh, Uh, Uh, Uu, Uu, Uu, Uu, Uh, Uh, Uu, Uu, Uu, Xor, Xor, Xu, Xu, Xu, Xu, Xu
Xu, Xu, Xu, Xu, Xu, Xu, Xu, Xu, Xor, Xor, Uu, Uu, Uu^Vud, Uh, Uu, Uh, Uh, Uu^Vud, Uu, Uu, Uu, Uu, Ce, Uu, Uu, Uh, Uh, Uu, Uh, Uu, Uh, Uu, Uu, Uu, Uu, Xor, Xor, Xu, Xu, Xu, Xu, Xu
Uu, Xu, Uu, Xu, Uu, Uu, Uu, Uu, Uu, Uu, Uu, Uu, Uu, Uh, Uu, Uu, Uu, Uh, Uh, Uu, Ce, Ce, 1 Ke, Ce, Uu, Uu, Uh, Uu, Uu, Uh, Uu, Uu, Uu, Uu, Uu, Uu, Uu, Xu, Xu, Xu, Uu, Uu
Uu, Uu, Xu, Uu, Xu, Xu, Xu, Xu, Xu, Xor, Uu, Uu, Uu, Uh, Uu, Uu, Uu, Uu, Uu, Uu, Uu, Ce, Ce, Ce, Uh, Uh, Uh, Uu, Uu, Uu, Uu, Uu, Uu, Uu, Uu, Xor, Xor, Uu, Xu, Uu, Uu, Xu
Uu, Uu, Uu, Xu, Xu, Xu, Xu, Xu, Xu, Xor, Uu, Uu, Uu, Uh, Uu, Uu, Uu, Uu, Uu, Uu, Uu, Uu, Uu, Uu, Uh, Uh, Uu, Uu^Vud, Uu, Uh, Uh, Uh, Uh, Uu, Uu, Xor, Xom, Uu, Uu, Uu, Xu, Xu
Xu, Xu, Xu, Uu, Uu, Xu, Uu, Xu, Xu, Xor, Uu, Uu, Uu, Uu, Uu, Uu, Uh, Uu^Vud, Uh, Uh, Uh, Uu, Uu, Uh, Uu, Uh, Uh, Uu, Uh, Uh, Uu, Uu^Vud, Uu, Uu, Uh, Xor, Xu, Xu, Xu, Uu, Xu, Xu
Xu, Xu, Xu, Xu, Xu, Uu, Xu, Uu, Uu, Xor, Uu, Uu, Uu, Uu^Vud, Uu, Uh, Uu, Uh, Uh, Uu, Uu, Uh, Uu, Uh, Uu, Uu, Uh, Uu, Uh, Uu, Uu, Uu, Uu, Uu, Uu, Xor, Xu, Xu, Xu, Xu, Xu, Xu
Xu, Xu, Xu, Xu, Xu, Xu, Xu, Xu, Xu, Uu, Uu, Uu, Uh, Uh, Uh, Uu, Uh, Uh, Uu, Uu, Uu, Uh, Uu^Vud, Uh, Uu, Uu, Uh, Uu, Uh, Uh, Uu, Uu, Uu, Uu, Uu, Xor, Xu, Xu, Xu, Xu, Xu, Xu
Xu, Xu, Xu, Xu, Xu, Xu, Xu, Xu, Xu, Xor, Uu, Uu, Uh, Uu, Uh, Uu, Uh, Uu^Vud, Uh, Uu, Uh, Uh, Uu, Uh, Uh, Uu, Uh, Uh, Uh, Uh, Uu, Uh, Uu, Uh, Uh, Xor, Xor, Xu, Xu, Xu, Xu, Xu
Xu, Xu, Xu, Xu, Xu, Xu, Xu, Xu, Xu, Xor, Uu, Uh, Uu, Uu, Uh, Uu, Uh, Uu, Uh, Uu, Uu, Uu, Uu, Uu, Uh, Uh, Uh, Uu, Uu, Uh, Uu^Vud, Uu, Uh, Uu, Uu, Xor, Xor, Xu, Xu, Xu, Xu, Xu
Xu, Xu, Xu, Xu, Xu, Xu, Xu, Xu, Xu, Xor, Uu, Uh, Uh, Uu, Uh, Uh, Uu, Uu, Xor, Xor, Uu, Xor, Xor, Uu, Uu^Vud, Uu, Uh, Uu, Uh, Uu, Uh, Uh, Uh, Uh, Uu, Uu, Uu, Xu, Xu, Xu, Xu, Xu
Xu, Xu, Uu, Xu, Xu, Xu, Xu, Xu, Xu, Xor, Xor, Uh, Uh, Uh, Uh, Uu, Xor, Xor, Xom, Xor, Uu, Xu, Xu, Xor, Xor, Uu, Uu, Uh, Uu, Uu, Uu, Uu, Uh, Uh, Xor, Xor, Xor, Uu, Uu, Xu, Uu, Xu
Uu, Uu, Xu, Uu, Uu, Uu, Uu, Xu, Xu, Xor, Uu, Uu, Xor, Uh, Xor, Xor, Xu, Xu, Xu, Xu, Uu, Xu, Xu, Xu, Xu, Xor, Xor, Uh, Uu, Uu, Uu, Uh, Xor, Xor, Xu, Xu, Xu, Xu, Uu, Uu, Xu, Uu
Xu, Xu, Xu, Xu, Xu, Xu, Xu, Uu, Uu, Uu, Xu, Xu, Xu, Xor, Xu, Xu, Xu, Xu, Xu, Xu, Uu, Xu, Xu, Xu, Xu, Xu, Xu, Xor, Xor, Uu, Uu, Xor, Xor, Xu, Xu, Xu, Xu, Uu, Xu, Xu, Xu, Xu
Xu, Xu, Xu, Xu, Xu, Xu, Uu, Uu, Uu, Xu, Uu, Xu, Xu, Xu, Xu, Xu, Xu, Xu, Xu, Xu, Uu, Xu, Xu, Xu, Xu, Xu, Xu, Xu, Xu, Xor, Xor, Uu, Uu, Xu, Xu, Xu, Xu, Uu, Xu, Xu, Xu, Xu
Xu, Xu, Xu, Xu, Xu, Xu, Uu, Uu, Xu, Uu, Uu, Xu, Xu, Xu, Xu, Xu, Xu, Xu, Xu, Xu, Uu, Xu, Uu, Xu, Xu, Xu, Xu, Xu, Xu, Xu, Xu, Xu, Uu, Xu, Xu, Xu, Uu, Uu, Xu, Xu, Xu, Xu
Xu, Xu, Xu, Xu, Uu, Uu, Xu, Uu, Xu, Xu, Xu, Uu, Uu, Xu, Xu, Xu, Xu, Xu, Uu, Uu, Xu, Uu, Uu, Uu, Uu, Xu, Xu, Xu, Xu, Xu, Xu, Xu, Uu, Xu, Xu, Xu, Uu, Xu, Xu, Xu, Xu, Xu
Xu, Xu, Uu, Uu, Xu, Xu, Xu, Uu, Uu, Xu, Xu, Xu, Uu, Xu, Xu, Xu, Xu, Xu, Uu, Xu, Xu, Xu, Uu, Uu, Xu, Uu, Uu, Xu, Xu, Xu, Xu, Xu, Uu, Uu, Uu, Xu, Uu, Xu, Xu, Xu, Xu, Xu
Uu, Uu, Xu, Xu, Xu, Xu, Uu, Uu, Uu, Xu, Xu, Xu, Xu, Uu, Xu, Xu, Xu, Xu, Uu, Xu, Uu, Uu, Uu, Xu, Xu, Xu, Uu, Xu, Xu, Xu, Xu, Xu, Uu, Xu, Xu, Uu, Uu, Uu, Uu, Xu, Xu, Xu
Uu, Xu, Xu, Xu, Uu, Uu, Xu, Xu, Uu, Xu, Xu, Xu, Xu, Uu, Xu, Xu, Xu, Xu, Uu, Uu, Xu, Xu, Uu, Xu, Uu, Uu, Uu, Uu, Xu, Xu, Xu, Xu, Uu, Xu, Xu, Xu, Xu, Xu, Xu, Uu, Uu, Xu
Xu, Xu, Uu, Uu, Xu, Xu, Xu, Xu, Uu, Uu, Xu, Xu, Xu, Uu, Xu, Xu, Xu, Xu, Uu, Xu, Xu, Xu, Uu, Uu, Xu, Xu, Uu, Uu, Xu, Xu, Xu, Xu, Uu, Xu, Xu, Xu, Xu, Xu, Xu, Xu, Uu, Xu
Uu, Uu, Xu, Xu, Xu, Xu, Xu, Xu, Uu, Uu, Xu, Xu, Xu, Uu, Xu, Xu, Xu, Xu, Uu, Uu, Uu, Uu, Uu, Uu, Uu, Uu, Uu, Xu, Xu, Xu, Xu, Xu, Uu, Xu, Xu, Xu, Xu, Xu, Xu, Xu, Uu, Xu
