Xu, Xu, Xu, Xu, Xu, Xu, Uu, Uu, Uu, Uu^Vu, Uu, Uu, Uu, Xu, Xu, Xu, Xu, Xu, Xu, Xu, Xu, Xu, Xu, Xu, Xu, Xu, Xu, Xu, Xu, Xu, Xu, Xu, Xu, Xu, Xu, Xu, Xu, Xu, Xu, Xu, Xu, Xu, Xu, Xu, Xu, Xu, Xu, Xu, Xu, Xu
Xu, Xu, Xu, Xu, Cud, Cud, Cud, Uu, Uu, Uu, Uu, Uu, Uu, Xu, Xu, Xu, Xu, Xu, Xu, Xu, Xu, Xu, Xu, Xu, Xu, Xu, Xu, Xu, Xu, Xu, Xu, Xu, Xu, Xu, Xu, Xu, Xu, Xu, Xu, Xu, Xu, Xu, Xu, Xu, Xu, Xu, Xu, Xu, Xu, Xu
Xu, Xu, Xu, Cud, Cud, 3 Kud, Cud, Uu, Uu, Uu, Uu, Uu^Vu, Uu, Uu, Uu, Xu, Xu, Xu, Xu, Xu, Xu, Xu, Xu, Xu, Xu, Xu, Xu, Xu, Xu, Xu, Xu, Xu, Xu, Xu, Xu, Xu, Xu, Xu, Xu, Xu, Xu, Xu, Xu, Xu, Xu, Xu, Xu, Xu, Xu, Xu
Xu, Xu, Xu, Uu, Uu, Cud, Uu, Uu, Uu, Uu, Uh, Uu, Uu, Uu, Uu^Vu, Uu, Uu, Xu, Xu, Xu, Xu, Xu, Xu, Xu, Xu, Xu, Xu, Xu, Xu, Xu, Xu, Xu, Xu, Xu, Xu, Xu, Xu, Xu, Xu, Xu, Xu, Xu, Xu, Xu, Xu, Xu, Xu, Xu, Xu, Xu
Xu, Xu, Xu, Uu, Uu, Uu, Uu, Uu, Uu, Uh, Uh, Uh, Uh, Uh, Uh, Uu, Uu, Uu, Uu, Xu, Xu, Xu, Xu, Xu, Xu, Xu, Xu, Xu, Uu, Xu, Uu, Xu, Uu, Xu, Uu, Xu, Uu^Vu, Xu, Xu, Xu, Xu, Xu, Xu, Xu, Xu, Xu, Xu, Xu, Xu, Xu
Xu, Xu, Xu, Xu, Xu, Uu^Vu, Uu, Uu, Uu, Uh, Uh, Uh, Uh, Uh, Uu, Uu, Uu^Vu, Uu, Uu, Uu, Uu, Xu, Xu, Xu, Xu, Xu, Uu, Uu, Uu, Uu, Uu, Uu, Uu, Uu, Uu, Uu, Uu, Uu, Uh, Xu, Xu, Xu, Xu, Xu, Xu, Xu, Xu, Xu, Xu, Xu
Xu, Xu, Xu, Xu, Xu, Xu, Uu, Uu, Uu^Vu, Uu, Uu, Uh, Uu, Uh, Uu, Uu, Uu, Uu, Uh, Uh, Uh, Uu, Uu, Xu, Uu, Uu, Uh, Uu, Uu, Uu, Uu, Uu, Uu, Uu, Uh, Uh, Uh, Uh, Uh, Uh, Uh, Xu, Xu, Xu, Xu, Xu, Xu, Xu, Xu, Xu
Xu, Xu, Xu, Xu, Xu, Xu, Uu, Uu, Uu, Uu, Uu, Uu^Vu, Uu, Uu, Uu, Uu, Uu, Uu, Uu, Uh, Uh, Uh, Uh, Uu, Uu, Uh, Uh, Uh, Uu, Uu, Uu, Uu, Uu, Uh, Uh, Uh, Uh, Uh, Uh, Uh, Uu, Uu, Uu, Xu, Xu, Xu, Xu, Xu, Xu, Xu
Xu, Xu, Xu, Xu, Xu, Xu, Uu, Uu, Uu, Uu, Uu, Uu, Uh, Uh, Uu, Uh, Uh, Uu, Uu, Uh, Uu, Uh, Uu, Uu, Uh, Uh, Uh, Uh, Uu, Uu, Uu, Uu, Uu^Vu, Uu, Uu, Uh, Uu, Uh, Uu, Uu, Uu^Vu, Uu, Xu, Xu, Xu, Xu, Xu, Xu, Xu, Xu
Xu, Xu, Xu, Xu, Xu, Xu, Uu, Uu, Uu, Uu, Uh, Uu, Uh, Uh, Uu, Uu, Uh, Uu, Uu, Uu^Vu, Uu, Uu, Uh, Uu, Uh, Uh, Uh, Uu, Uu, Uu, Uu, Uu, Uu, Uu, Uu, Uu, Uu, Uu^Vu, Uu, Uu, Uu, Xu, Xu, Xu, Xu, Xu, Xu, Xu, Xu, Xu
Xu, Xu, Xu, Xu, Xu, Xu, Uu, Uu, Uu, Uh, Uu, Uh, Uh, Uh, Uh, Uh, Uh, Uu, Uu, Uu, Uu, Uu, Uu, Uh, Uu, Uh, Uu, Uu^Vu, Uu, Uu, Uu, Uh, Uu, Uh, Uh, Uu, Uu, Uu, Uu, Uu, Xu, Xu, Xu, Xu, Xu, Xu, Xu, Xu, Xu, Xu
Xu, Xu, Xu, Xu, Xu, Xu, Uu, Uu^Vu, Uu, Uu, Uu, Uu, Uu, Uh, Uu, Uu, Uu, Uu, Uu, Uu, Uu, Uu, Uh, Uu, Uu, Uu, Uu, Uu, Uu, Uu, Uh, Uh, Uh, Uh, Uh, Uh, Uu, Uu, Uu, Uu, Xu, Xu, Xu, Xu, Xu, Xu, Xu, Xu, Xu, Xu
Xu, Xu, Xu, Xu, Xu, Xu, Uu, Uu, Uu, Uu, Uu, Uu^Vu, Uu, Uu, Uu, Uu, Uu, Uu^Vu, Uh, Uh, Uh, Uh, Uu, Uh, Uh, Uu, Uu, Uu, Uu, Uh, Uh, Uh, Uh, Uh, Uu, Uu, Uu, Uu, Uu, Uu, Uu, Xu, Xu, Xu, Xu, Xu, Xu, Xu, Xu, Xu
Xu, Xu, Xu, Xu, Xu, Xu, Uu, Uu, Uu, Uu, Uu, Uu, Uu, Uu, Uu, Uu, Uh, Uu, Uh, Uh, Uu, Uh, Uu, Uh, Uh, Uh, Uh, Uu, Uu, Uu^Vu, Uu, Uh, Uu, Uu, Uu, Uu, Uh, Uh, Uu, Uu, Uu, Xu, Xu, Xu, Xu, Xu, Xu, Xu, Xu, Xu
Xu, Xu, Xu, Xu, Xu, Xu, Uu^Vu, Uu, Uu, Uu, Uu, Uu, Uh, Uu, Uu, Uu^Vu, Uu, Uu, Uu, Uu, Uu, Uu, Uu, Uu, Uu^Ii, Uu, Uh, Uh, Uu, Uu, Uh, Uu, Uu, Uu, Qxu, Uu, Uu, Uh, Uu, Uu, Uu, Xu, Xu, Xu, Xu, Xu, Xu, Xu, Xu, Xu
Xu, Xu, Xu, Xu, Xu, Xu, Uu, Uu, Uu, Uu, Uh, Uh, Uu, Uh, Uu, Uu, Uu, Uu, Uu, Uu, Uu^Vu, Uu, Uu, Uu, Uu, Uu, Uu, Uu^Vu, Uh, Uu, Uu, Uh, Uu, Uu, Qxu, Qxu, Uu, Uh, Uu, Uu, Uu, Xu, Xu, Xu, Xu, Xu, Xu, Xu, Xu, Xu
Xu, Xu, Xu, Xu, Xu, Xu, Uu, Uu, Uu, Uh, Uh, Uu, Uu, Uu, Uu, Uu^Vu, Uu, Uu, Uh, Uh, Uu, Uu, Uu, Uu, Uu, Uu, Uu, Uh, Uu, Uh, Uh, Uh, Uu^Vu, Uu, Uu, Uu, Uu, Uh, Uu, Uu, Uu, Xu, Xu, Xu, Xu, Xu, Xu, Xu, Xu, Xu
Xu, Xu, Xu, Xu, Xu, Xu, Uu, Uu, Uu, Uh, Uh, Uu^Vu, Uu, Uu, Uu, Uu, Uu, Uu, Uh, Uh, Uu, Uu, Uu, Uu, Cud, Uu, Uu, Uu, Uu, Uh^Ii, Uh, Uh, Uu, Uu, Uu, Uu, Uu, Uu, Uu, Uu^Vu, Uu, Xu, Xu, Xu, Xu, Xu, Xu, Xu, Xu, Xu
Xu, Xu, Xu, Xu, Xu, Xu, Uu, Uu, Uu^Vu, Uu, Uu, Uu, Uu, Uu, Uu, Uu, Uh, Uh, Uh, Uh^Ii, Uu, Uu, Cud, Cud, Cud, Cud, Cud, Uu, Uu, Uu, Uu^Vu, Uu, Uu, Uu, Uh, Uh, Uh, Uu, Uu, Uu, Uu, Xu, Xu, Xu, Xu, Xu, Xu, Xu, Xu, Xu
Xu, Xu, Xu, Xu, Uu, Uu, Uu, Uu, Uh, Uu, Uh, Uu, Uu^Vu, Uu, Uu, Uh, Uh, Uh, Uu, Uu, Uu, Uu, Cud, Cud, 2 Kud, Cud, Cud, Uu, Uu, Uu, Uu, Uu, Ce, Ce, Ce, Uh, Uu, Uh, Uh, Uu^Vu, Uu, Xu, Xu, Xu, Xu, Xu, Xu, Xu, Xu, Xu
Xu, Xu, Uu, Uu, Uu, Uu, Uu, Uu, Uh, Uh, Uh, Uh, Uu, Uu, Uu, Uh, Uu^Vu, Uu, Uu, Uu, Uu, Uu, Cud, Cud, Cud, Cud, Cud, Uu, Uu, Uu, Uu, Uu, Ce, 1 Ke, Ce, Uu, Uu, Uh, Uh, Uh, Uu, Uu, Uu, Xu, Xu, Xu, Xu, Xu, Xu, Xu
Uu, Uu, Uu, Uu, Uu^Vu, Uu, Uu, Uu, Uu, Uh, Uh, Uh, Uu, Uu, Uu, Uu, Uu, Uu, Uu, Uu^Vu, Uu, Uu, Uu, Cud, Cud, Cud, Uu, Uu, Uu^Vu, Uu, Uu, Uu, Uu, Ce, Uu, Uu, Uu, Uu, Uu, Uu, Uu, Uu, Uu, Xu, Xu, Xu, Xu, Xu, Xu, Xu
Uu, Uu, Uu, Uu, Uh, Uu, Qxu, Qxu, Qxu, Uu, Uu, Uh, Uh, Uu, Uu, Uu, Uu, Uu^Vu, Uh, Uu, Uu, Uu, Uu, Uu, Uu, Uu, Uu, Uu, Uu, Uu, Uu, Uu, Uu, Uu, Uu, Uu, Uu, Uu, Uu^Vu, Uu, Uu, Uu, Uu, Uu, Uu, Xu, Xu, Xu, Xu, Xu
Uu, Uu, Uu, Uh, Uu, Uu, Qxu, Qxu, Qxu, Uu, Uh, Uh, Uu, Uh, Uh, Uu, Uu, Uh, Uu, Uh^Ii, Uu, Uu, Uu^Vu, Uu, Uu, Uu, Uu, Uu, Uh, Uh^Ii, Uu, Uu, Uu, Uu, Uu, Uu, Uu, Uu, Uu, Uu, Uu, Uu, Uu, Uu, Uu, Uu, Uu, Xu, Xu, Xu
Uu, Uu, Uh, Uh, Uh, Uu, Uu, Qxu, Uu, Uu, Uh, Uu, Uu, Uu, Uu, Uu, Uu^Vu, Uu, Uh, Uh, Uu, Uu, Uu, Uu, Uu^Ii, Uu, Uu, Uu, Uh, Uh, Uu, Uu, Uh, Uu^Vu, Uu, Uh, Uu^Vu, Uu, Uu, Uu, Uu, Uu, Uu, Uu, Uu, Uu, Uu, Uu, Uu, Xu
Uu, Uu, Uu, Uh, Uh, Uh, Uu^Vu, Uu, Uu, Uu, Uu, Uu^Vu, Uu, Uu, Uu, Uu, Uu, Uu, Uu, Uu, Uu, Uu, Uu, Uu^Vu, Uu, Uh, Uu, Uh, Uu, Uu, Uu, Uu, Uu, Uh, Uh, Uu, Uu, Uh, Uh, Uu, Uu, Uu, Uu, Uu, Uu, Uu, Uu, Uu, Uu, Qxu
Uu, Uu, Uu, Uu^Vu, Uu, Uu, Uu, Uu, Uu, Uu, Uh, Uh, Uh, Uu, Uu, Uh, Uh, Uu, Uu^Vu, Uu, Uu, Uu, Uu, Uu, Uu, Uh, Uh, Uu, Uu, Uu, Uu, Uu, Uu, Uu, Uu, Uh, Uu, Uh, Uh, Uh, Uh, Uu, Uu, Uu, Uh, Uu, Uh, Uh, Uh, Qxu
Uu, Uu, Uu, Uu, Uu, Uu, Uu, Uu, Uh, Uh, Uh, Uu, Uu, Uu, Uu, Uh, Uh, Uh, Uu, Uu, Uh, Uu, Uh, Uu, Uh, Uu, Uh, Uu, Uu, Uu, Uu^Vu, Uu, Uu, Uu, Uu, Uu, Uu, Uu, Uu, Uh, Uu, Uu, Uu, Uu, Uu, Uh, Uh, Uh, Uh, Uu
Uu, Uu, Uu, Uu, Uu, Uu, Uu, Uh, Uh, Uh, Uh, Uu, Uu, Uu, Uu, Uu, Uu, Uh, Uu, Uu, Uu, Uh, Uu, Uu, Uu, Uh, Uu, Uu, Uu, Uu, Uh, Uu, Uu, Uu, Uu, Uu, Uu, Uu, Uu^Vu, Uu, Uu, Uu, Uu, Uu^Vu, Uu, Uu, Uu, Uh, Uh, Uh
Uu, Uu, Uu, Uu, Uu, Uu^Vu, Uu, Uu, Uu, Uu, Uu, Uu, Uu, Uu, Uh, Uu, Uu, Uu, Uu, Uu, Uu^Vu, Uu, Uu, Uu, Uu, Uu, Uu, Uu, Uh, Uh, Uu, Uh, Uh, Uu, Uu, Uu, Uu, Uu, Uu, Uu, Uh, Uu, Uu, Uu, Uu, Uu, Uu, Uh, Uh, Uh
Uu, Uu, Uu, Uu, Uu, Uu, Uu, Uu, Uu, Uu, Uu^Vu, Uu, Uu, Uh, Uu, Uh, Uh, Uu, Uu, Uu, Uu, Uu, Uh, Uh, Uh, Uh, Uh, Uh, Uh, Uu, Uh, Uh, Uu, Uu, Uu, Uu, Uu, Uu, Uh, Uh, Uh, Uu, Uu, Uu, Uu^Vu, Uu, Uu, Uh, Uh, Uu
Uu, Uu, Uu, Uu, Uh, Uh, Uu, Uu, Uu, Uu, Uu, Uu, Uu, Uu, Uu, Uu, Uu, Uh, Uh, Uu, Uh, Uh, Uu, Uh, Uu, Uh, Uu, Uu, Uu, Uh, Uu, Uu, Uu, Uu, Uu^Vu, Uu, Uu, Uh, Uh, Uh, Uh, Uh, Uu, Uu, Uu, Uu, Uu^Vu, Uu, Uh, Uh
Uu, Uu, Uh, Uh, Uu, Uh, Uh, Uu, Uu, Uu, Uu^Vu, Uu, Uu, Uu^Vu, Uu, Uu, Uu, Uu, Uh, Uu, Uu, Uu, Uu, Uu, Uu, Uu, Uu, Uu, Uh, Uu, Uh, Uu, Uu, Uu, Uu, Uu, Uu, Uh, Uu, Uh, Uu, Uu, Uu, Uu, Cud, Uu, Uu, Uu, Uu, Uu
Uu, Uu, Uh, Uu, Uu, Uh, Uu^Vu, Uu, Uu, Uu, Uu, Uu, Uu, Uu, Uu, Uu, Uu, Uh, Uu, Uu, Uu, Uu, Uh, Uu, Uu, Uu, Uu, Uu, Uh, Uu, Uh, Uh, Uh, Uu, Uu, Uu, Uu, Uu, Uu^Vu, Uu, Uu, Uu, Uu, Cud, 4 Kud, Cud, Uu, Uu, Uu, Uu
Uu, Uu, Uh, Uh, Uh, Uh, Uu, Uu, Uu, Uh, Uh, Uu, Uu, Uu, Uu, Uu, Uu^Vu, Uu, Uu, Uu, Uh, Uh, Uh, Uh, Uu, Uu, Uu, Uu, Uu, Uh, Uh, Uh, Uh, Uh, Uh, Uu, Uu, Uu, Uh, Uu, Uu, Uu, Uu, Cud, Cud, Cud, Uu, Uu, Uu, Uu
Qxu, Uu, Uu, Uu, Uu, Uu, Uu, Uu, Uu, Uh, Uh, Uu, Uu, Uh, Uu, Uu, Uu, Uu, Uu, Uu, Uh, Uu, Uh, Uh, Uu, Uu, Uu, Uu, Uu, Uu, Uu, Uu, Uu, Uu, Uu, Uu, Uh, Uh, Uu, Uu, Uu, Uu, Uh, Uh, Uh, Uh, Uu, Uu, Uu, Uu
Qxu, Qxu, Uu, Uu, Uu, Uu, Uu, Uu, Uu, Uu, Uu, Uh, Uu, Uh, Uh, Uh, Uh, Uu, Uu, Uh, Uu, Uh, Uh, Uu, Uu, Uu, Uu, Uh, Uh, Uu, Uh, Uu, Uu, Uu, Uu, Uu, Uh, Uh, Uu, Uu^Vu, Uu, Uh, Uh, Uh, Uu, Uu, Uu, Uu, Uu, Uu
Qxu, Qxu, Qxu, Uu, Uu, Uu, Uu, Uu, Uu, Uu, Uu, Uu, Uu, Uu, Uu, Uh, Uh, Uu, Uu, Uu, Uu, Uu, Uu, Uu, Uu, Uu, Uu, Uh, Uh, Uh, Uh, Uh, Uh, Uu, Uu, Uu, Uu, Uu, Uu, Uu^Vu, Uu, Uh, Uh, Uu, Qxu, Qxu, Qxu, Qxu, Qxu, Uu
Qxu, Qxu, Qxu, Qxu, Qxu, Uu, Uu, Uu, Uu, Uu, Uu, Uu, Uu, Uu, Uu, Uh, Uh, Uu, Uu, Uu, Uu, Uu, Uu, Uu, Uu, Uu, Uu, Uh, Uu, Uu, Uu, Uh, Uh, Uu, Uh, Uu, Uu, Uu, Uu, Uu, Uu, Uu, Uu, Uu, Qxu, Qxu, Qxu, Qxu, Qxu, Qxu
