Xu, Xu, Xu, Xu, Xu, Xu, Uu, Uu, Uu, Uu, Uu, Uu, Uu, Uu, Uu, Uu, Uu, Uu, Ur, Ur, Ur, Uu, Uu, Uu, Uu, Uu, Uu, Xu, Xu, Xu, Xu, Xu, Xu, Xu, Xu, Xu
Xu, Xu, Xu, Xu, Uu, Xu, Uu, Uu, Uu, Uu, Uu, Uu, Uh, Uu, Uu, Uu, Uu, Uu, Ur, Ur, Ur, Uu, Uu, Uu, Uh, Uh, Uu, Uu, Uu, Uu, Uu, Uu, Xu, Xu, Xu, Xu
Xu, Xu, Xu, Uu, Uu, Uu, Uu, Uu, Uu, Uu, Uh, Uh, Uh, Uh, Uh, Uu, Uu, Uu, Ur, Ur, Ur, Uu, Uu, Uu, Uh, Uh, Uh, Uu, Xu, Xu, Xu, Xu, Xu, Xu, Xu, Xu
Xu, Xu, Uu, Uu, Xu, Xu, Uu, Uu, Uh, Uh, Uh, Uh, Uh, Uh, Uh, Uu, Uu, Uu, Ur, Ur, Ur, Uu, Uu, Uh, Uh, Uh, Uh, Xu, Xu, Xu, Uu, Xu, Xu, Xu, Xu, Xu
Xu, Xu, Xu, Uu, Xu, Xu, Uu, Uu, Uh, Uh, Uh, Uh, Uh, Uh, Uu, Uu, Uu, Uu, Ur, Ur, Ur, Uu, Uu, Uh, Uu, Uh, Uu, Xu, Uu, Uu, Uu, Xu, Xu, Xu, Xu, Xu
Xu, Xu, Xu, Uu, Xu, Xu, Uh, Uh, Uh, Uh, Uh, Uh, Uh, Uh, Uu, Uu, Uu, Uu, Ur, Ur, Ur, Uu, Uu, Uh, Uh, Uu, Uu, Uu, Xu, Xu, Uu, Xu, Xu, Xu, Xu, Xu
Xu, Xu, Xu, Xu, Xu, Xu, Xu, Xu, Xu, Uh, Uu, Uh, Uu, Uh, Uh, Uu, Uu, Uu, Ur, Ur, Ur, Uu, Uu, Uu, Uu, Uu, Uu, Xu, Xu, Xu, Uu, Uu, Xu, Xu, Xu, Xu
Xu, Xu, Xu, Xu, Xu, Xu, Xu, Uu, Uu, Uu, Uu, Uu, Uu, Uu, Uu, Uu, Uu, Uu, Ur, Ur, Ur, Uu, Uu, Uu, Uu, Uu, Uu, Xu, Xu, Xu, Xu, Uu, Xu, Xu, Xu, Xu
Xu, Xu, Xu, Xu, Xu, Xu, Xu, Uu, Uu, Uu, Uu, Uu, Uu, Uu, Uu, Uu, Uu, Uu, Ur, Ur, Ur, Uu, Uu, Uu, Uu, Uu, Uu, Xu, Uu, Xu, Uu, Uu, Uu, Xu, Xu, Xu
Xu, Xu, Xu, Xu, Uu, Uu, Uu, Uu, Uu, Uu, Uu, Uu, Uh, Uh, Uh, Uu, Uu, Uu, Ur, Ur, Ur, Uu, Uu, Uu, Uu, Uh, Uh, Uu, Xu, Uu, Xu, Uu, Uu, Xu, Xu, Xu
Xu, Xu, Xu, Xu, Xu, Xu, Xu, Uu, Uu, Uu, Uu, Uh, Uh, Uh, Uh, Uu, Uu, Uu, Ur, Ur, Ur, Uu, Uu, Uu, Uh, Uh, Uh, Uu, Xu, Xu, Xu, Uu, Xu, Xu, Xu, Xu
Xu, Xu, Xu, Xu, Xu, Xu, Uu, Uu, Uu, Uu, Uh, Uh, Uh, Uh, Uh, Uu, Uu, Uu, Ur, Ur, Ur, Uu, Uu, Uu, Uh, Uu, Uh, Uu, Xu, Xu, Xu, Uu, Xu, Xu, Xu, Xu
Xu, Xu, Xu, Xu, Xu, Uu, Uu, Uu, Uh, Uh, Uh, Uh, Uh, Uh, Uu, Uu, Uu, Uu, Ur, Ur, Ur, Uu, Uu, Uu, Uh, Uh, Uh, Uu, Xu, Xu, Xu, Xu, Xu, Xu, Xu, Xu
Xu, Xu, Xu, Xu, Xu, Uu, Uu, Uh, Uu, Uh, Uu, Uh, Uu, Uu, Uu, Uu, Uu, Uu, Ur, Ur, Ur, Uu, Uu, Uh, Uh, Uh, Uu, Uu, Xu, Xu, Xu, Xu, Xu, Xu, Xu, Xu
Xu, Xu, Xu, Xu, Xu, Uu, Uh, Xu, Uu, Uu, Uu, Uu, Uu, Uu, Uu, Uu, Uu, Uu, Ur, Ur, Ur, Uu, Uu, Uu, Uh, Uh, Xu, Uu, Xu, Xu, Xu, Uu, Uu, Xu, Xu, Xu
Xu, Xu, Xu, Xu, Xu, Uh, Xu, Xu, Uu, Uu, Uu, Uu, Uh, Uu, Uh, Uu, Uu, Uu, Ur, Ur, Ur, Uu, Uu, Uu, Uu, Uu, Uu, Xu, Uu, Xu, Xu, Xu, Xu, Uu, Xu, Xu
Xu, Xu, Xu, Xu, Xu, Uh, Xu, Uu, Uh, Uu, Uh, Uh, Uh, Uh, Uu, Uu, Uu, Uu, Ur, Ur, Ur, Uu, Uu, Uu, Uu, Uu, Uh, Uu, Uh, Uu, Uu, Xu, Uu, Uu, Xu, Xu
Xu, Xu, Xu, Xu, Xu, Xu, Uu, Uu, Uh, Uh, Uh, Uh, Uh, Uh, Uu, Uu, Uu, Uu, Ur, Ur, Ur, Uu, Uu, Uu, Uu, Uu, Uh, Uh, Uh, Uh, Uu, Uu, Xu, Xu, Xu, Xu
Xu, Xu, Xu, Xu, Xu, Uu, Uu, Uu, Uu, Uh, Uu, Uh, Uu, Uu, Uu, Uu, Uu, Uu, Ur, Ur, Ur, Uu, Uu, Uu, Uu, Uu, Uh, Uh, Uh, Uh, Uu, Xu, Xu, Xu, Xu, Xu
Xu, Xu, Xu, Xu, Xu, Xu, Xu, Uu, Uu, Uu, Uu, Uu, Uu, Uu, Uu, Uu, Uu, Uu, Ur, Ur, Ur, Uu, Uu, Uu, Uu, Uu, Uu, Uh, Uu, Uh, Uu, Xu, Xu, Xu, Xu, Xu
Xu, Xu, Xu, Xu, Uu, Uu, Uu, Xu, Uu, Uu, Uu, Uu, Uu, Uu, Qxu, Qxu, Qxu, Uu, Ur, Ur, Ur, Uu, Qxu, Qxu, Qxu, Uu, Uu, Uu, Uu, Uh, Uu, Xu, Xu, Xu, Xu, Xu
Xu, Xu, Xu, Uu, Uu, Uu, Uu, Uu, Uu, Uu, Uu, Uu, Qxu, Qxu, Qxu, Qxu, Qxu, Qxu, Ur, Ur, Ur, Qxu, Qxu, Qxu, Qxu, Qxu, Uu, Uu, Uu, Uu, Uu, Uu, Uu, Xu, Xu, Xu
Xu, Xu, Xu, Xu, Uu, Uu, Uh, Uh, Uh, Uh, Uu, Uu, Qxu, Qxu, Qxu, Qxu, Qxu, Qxu, Qxu^Bs|, Qxu, Qxu^Bs|, Qxu, Qxu, Qxu, Qxu, Qxu, Uu, Uu, Uu, Uh, Uu, Uu, Uu, Xu, Xu, Xu
Xu, Xu, Xu, Uu, Uu, Uu, Uu, Uh, Uh, Uh, Uu, Uu, Qxu, Qxu, Qxu, Qxu, Qxu, Qxu, Qxu^Bs|, Qxu, Qxu^Bs|, Qxu, Qxu, Qxu, Qxu, Qxu, Uu, Uu, Uh, Uh, Uu, Xu, Xu, Uu, Xu, Xu
Xu, Xu, Xu, Uu, Xu, Uu, Uu, Uh, Uh, Uh, Uu, Uu, Qxu, Qxu, Qxu, Qxu, Qxu, Qxu, Qxu^Bs|, Qxu, Qxu^Bs|, Qxu, Qxu, Qxu, Qxu, Qxu, Uu, Uu, Uh, Uh, Uu, Xu, Uu, Uu, Xu, Xu
Xu, Xu, Xu, Xu, Xu, Uu, Uu, Uu, Uh, Uh, Uu, Uu, Qxu, Qxu, Qxu, Qxu, Qxu, Qxu, Qxu^Bs|, Qxu, Qxu^Bs|, Qxu, Qxu, Qxu, Qxu, Qxu, Uu, Uu, Uh, Uh, Uu, Xu, Xu, Xu, Xu, Xu
Xu, Xu, Xu, Xu, Uu, Uu, Uu, Uu, Uh, Uh, Uu, Uu, Qxu, Qxu, Qxu, Qxu, Qxu, Qxu, Ur, Qxu, Ur, Qxu, Qxu, Qxu, Qxu, Qxu, Uu, Uu, Uu, Uu, Uu, Xu, Xu, Xu, Xu, Xu
Xu, Xu, Xu, Uu, Xu, Xu, Xu, Uu, Xu, Xu, Uu, Uu, Uu, Qxu, Qxu, Qxu, Uu, Uu, Ur, Ur, Ur, Qxu, Qxu, Qxu, Uu, Uu, Uu, Uu, Uu, Xu, Uu, Xu, Xu, Xu, Xu, Xu
Xu, Xu, Xu, Xu, Xu, Xu, Xu, Xu, Uu, Uu, Uu, Uu, Uh, Uu, Uu, Uu, Uu, Uu, Ur, Ur, Ur, Uu, Uu, Uu, Uu, Uu, Uh, Uh, Uu, Xu, Xu, Xu, Xu, Xu, Xu, Xu
Xu, Xu, Xu, Xu, Xu, Xu, Xu, Xu, Uu, Uu, Uu, Uu, Uu, Uh, Uh, Uh, Uu, Uu, Ur, Ur, Ur, Uu, Uu, Uu, Uu, Uu, Uh, Uh, Uu, Uu, Uu, Xu, Xu, Xu, Xu, Xu
Xu, Xu, Xu, Xu, Xu, Xu, Xu, Xu, Uu, Uu, Uu, Uu, Uu, Uu, Uu, Uh, Uh, Uu, Ur, Ur, Ur, Uu, Uu, Uu, Uu, Uh, Uh, Uh, Uu, Xu, Xu, Uu, Xu, Xu, Xu, Xu
Xu, Xu, Xu, Xu, Xu, Xu, Xu, Xu, Uu, Uu, Uu, Uh, Uh, Uu, Uu, Uu, Uu, Uu, Ur, Ur, Ur, Uu, Uu, Uu, Uu, Uh, Uh, Uh, Uu, Xu, Xu, Uu, Xu, Xu, Xu, Xu
Xu, Xu, Xu, Xu, Xu, Uu, Xu, Xu, Uu, Uu, Uh, Uh, Uh, Uh, Uu, Uu, Uu, Uu, Ur, Ur, Ur, Uu, Uu, Uu, Uu, Uu, Uu, Uh, Xu, Xu, Xu, Uu, Xu, Xu, Xu, Xu
Xu, Xu, Xu, Xu, Xu, Uu, Xu, Xu, Uu, Uu, Uu, Uh, Uu, Uh, Uu, Uu, Uu, Uu, Ur, Ur, Ur, Uu, Uu, Uu, Uu, Uu, Uu, Uu, Uu, Xu, Xu, Xu, Xu, Xu, Xu, Xu
Xu, Xu, Xu, Xu, Xu, Uu, Xu, Xu, Uu, Uu, Uu, Uu, Uu, Uu, Uu, Uu, Uu, Uu, Ur, Ur, Ur, Uu, Uu, Uu, Uh, Uu, Uu, Uu, Xu, Uu, Uu, Xu, Xu, Xu, Xu, Xu
Xu, Xu, Xu, Xu, Uu, Uu, Xu, Xu, Uu, Uu, Uu, Uu, Uu, Uu, Uh, Uu, Uu, Uu, Ur, Ur, Ur, Uu, Uu, Uu, Uh, Uh, Uu, Uu, Xu, Xu, Xu, Uu, Xu, Xu, Xu, Xu
Xu, Xu, Xu, Xu, Xu, Uu, Uu, Xu, Uu, Uu, Uu, Uh, Uh, Uh, Uu, Uu, Uu, Uu, Ur, Ur, Ur, Uu, Uu, Uu, Uh, Uu, Uu, Uu, Xu, Xu, Uu, Uu, Xu, Xu, Xu, Xu
Xu, Xu, Xu, Xu, Xu, Xu, Xu, Uu, Uu, Uu, Uu, Uu, Uu, Uu, Uu, Uu, Uu, Uu, Ur, Ur, Ur, Uu, Uu, Uh, Uh, Uh, Uu, Uu, Xu, Xu, Uu, Xu, Xu, Xu, Xu, Xu
Xu, Xu, Xu, Xu, Xu, Xu, Xu, Xu, Uu, Uu, Xu, Uu, Uh, Uu, Uu, Uu, Uu, Uu, Ur, Ur, Ur, Uu, Uu, Uh, Uh, Uh, Uu, Uu, Xu, Xu, Uu, Xu, Xu, Xu, Xu, Xu
Xu, Xu, Xu, Xu, Xu, Xu, Xu, Xu, Uu, Uu, Xu, Uu, Uh, Uh, Uh, Uu, Uu, Uu, Ur, Ur, Ur, Uu, Uu, Uu, Uu, Uu, Uu, Uu, Uu, Uu, Xu, Xu, Xu, Xu, Xu, Xu
Xu, Xu, Xu, Xu, Xu, Xu, Xu, Xu, Xu, Xu, Uu, Uu, Uu, Uh, Uh, Uh, Uu, Uu, Ur, Ur, Ur, Uu, Uu, Uu, Uh, Uu, Uu, Uu, Xu, Xu, Xu, Xu, Xu, Xu, Xu, Xu
Xu, Xu, Xu, Xu, Xu, Xu, Xu, Xu, Uu, Uu, Uu, Uu, Uu, Uh, Uh, Uh, Uu, Uu, Ce, Ce, Ce, Uu, Uu, Uh, Uh, Uu, Uu, Uu, Xu, Xu, Xu, Xu, Xu, Xu, Xu, Xu
Xu, Xu, Xu, Xu, Xu, Xu, Xu, Xu, Uu, Uu, Uu, Uu, Uh, Uh, Uh, Uh, Uu, Uu, Ce, 1 Ke, Ce, Uu, Uu, Uh, Uh, Uh, Uu, Uu, Uu, Xu, Xu, Xu, Xu, Xu, Xu, Xu
Xu, Xu, Xu, Xu, Xu, Xu, Xu, Xu, Uu, Uu, Uu, Uu, Uh, Uh, Uu, Uh, Uu, Uu, Ur, Ce, Ur, Uu, Uu, Uh, Uh, Uh, Uu, Uu, Uu, Uu, Uu, Xu, Xu, Xu, Xu, Xu
Xu, Xu, Xu, Xu, Xu, Xu, Xu, Xu, Uu, Uu, Uu, Uu, Uu, Uu, Uu, Uu, Uu, Uu, Ur, Ur, Ur, Uu, Uu, Uu, Uu, Uh, Uu, Uu, Uu, Uu, Uu, Uu, Xu, Xu, Xu, Xu
