Mm, Mm, Mm, Mm, Mm, Mm, Mm, Mm, Mm, Mm^Xm, Mm^Xm, Mm^Xm, Mm^Xm, Mm^Xm, Xu, Uu, Uu, Uu, Uu, Uu, Uu, Uu, Uu, Uu, Uu, Uu, Uu, Uu, Uu
Mm, Mm, Mm, Mm, Mm, Mm, Mm, Mm, Mm, Mm^Xm, Mm^Xm, Mm^Xm, Mm^Xm, Mm^Xm, Xu, Uu, Uu, Uu, Uu, Uu, Uu^Vud, Uu, Uu, Uu, Cud, Uu, Uu, Uu, Uu
Mm, Mm, Hh, Hh, Hh, Hh, Hh, Hh, Hh, Mm^Xm, Hh, Mm^Xm, Mm^Xm, Mm^Xm, Xu, Uu, Uu, Uu^Vud, Uu, Uu, Uu, Uu, Uu, Cud, 1 Kud, Cud, Uu, Uu^Vud, Uu
Mm, Hh, Hh, Hh, Hh, Hh, Hh, Gll^Fp, Hh, Hh, Hh, Hh, Hh, Hh, Gll^Fp, Xu, Xu, Uu, Uu, Uu, Uu^Vud, Uu, Uu, Cud, Cud, Cud, Uu, Uu, Uu
Mm, Hh, Hh, Gll^Fp, Hh, Hh, Gg^Fet, Hh, Hh, Gll^Fp, Hh, Hh, Gll^Fp, Gll^Fp, Gll^Fp, Gll^Fp, Gll^Fp, Xu, Xu, Uu, Uu, Uu, Uu, Uu, Uu, Uu, Uu, Uu, Uu
Mm, Hh, Hh, Gll^Fp, Hh, Hh, Hh, Hh, Gll^Fp, Gll^Fp, Gll^Fp, Hh, Gll^Fp, Gll^Fp, Gg^Efm, Gg^Efm, Gg, Gg, Rb, Rb, Rb, Uu, Uu, Uu, Uu^Vud, Uu, Uu^Vud, Uu, Uu
Hh, Hh, Gll^Fp, Hh, Gll^Fp, Gll^Fp, Gll^Fp, Gll^Fp, Gg, Gll^Fp, Gll^Fp, Gll^Fp, Gg, Gg^Efm, Gg^Efm, Gg^Efm, Gg, Gg, Rb, Rb, Rb, Rb, Xu, Uu, Uu, Uu, Uu, Uu, Uu
Gg, Gll^Fp, Gg, Gll^Fp, Gg, Gg, Gg, Gg, Gg^Wm, Gg, Gg, Gg, Gg, Gg, Gg, Gg, Rb, Rb, Rb, Rb, Gg, Rb, Gg, Xu, Xu, Uu, Uu, Uu^Vud, Uu
Gg, Gg, Gg, Gg, Gg^Gvs, Gg^Gvs, Gg^Gvs, Gg^Gvs, Gg^Gvs, Gg^Gvs, Gg, Gg, Gg, Gg, Rb, Rb, Rb, Rb, Gg, Gg, Gg, Gg, Gg, Hh, Gll^Fp, Xu, Xu, Uu, Xu
Gg, Gg, Gg, Gg^Gvs, Gg^Gvs, Gg^Gvs, Gg^Gvs, Gg^Gvs, Gg^Gvs, Gg^Gvs, Gg, Gg, Rb, Rb, Rb, Rb, Gg, Gg, Gg, Gg, Gg, Gg, Gg, Hh, Gll^Fp, Hh, Mm, Xu, Mm^Xm
Gg, Gg, Gg, Gg^Gvs, Gg, Gg^Gvs, Gg, Gg^Gvs, Gg, Gg, Rb, Rb, Rb, Rb, Gg, Gg, Gg, Gg, Gg^Gvs, Gg^Gvs, Gg^Gvs, Gg, Gg, Gll^Fp, Gll^Fp, Hh, Mm, Mm^Xm, Mm^Xm
Gg^Efm, Gg^Efm, Gg^Efm, Gg, Gg, Gg, Gg, Gg, Rb, Rb, Rb, Rb, Gg, Gg, Gg, Gg, Gg^Gvs, Gg^Gvs, Gg^Gvs, Gg^Gvs, Gg^Gvs, Gg^Efm, Hh, Gll^Fp, Gll^Fp, Hh, Mm, Mm^Xm, Mm^Xm
Gg^Efm, Gg^Efm, Gg, Gg, Gg, Gg, Rb, Rb, Rb, Rb, Gg, Gg, Gg, Gg, Gg, Gg^Gvs, Gg^Gvs, Gg^Gvs, Gg^Gvs, Gg^Gvs, Gg^Gvs, Gg^Efm, Hh, Hh, Gll^Fp, Hh, Mm, Mm, Mm
Gg, Gg, Gg, Gg, Rb, Rb, Rb, Rb, Gg, Gg, Gg, Gg, Gg, Gg, Gg, Gg^Gvs, Gg^Gvs, Gg^Gvs, Gg^Gvs, Gg^Gvs, Gg^Wm, Gg^Efm, Gll^Fp, Gll^Fp, Hh, Hh, Mm, Mm, Mm
Gg, Gg, Rb, Rb, Rb, Rb, Gg, Gg, Gg, Gg, Gg, Gg, Gg, Gg, Gg, Gg, Gg, Gg^Gvs, Gg^Gvs, Gg^Gvs, Gg, Gg, Gll^Fp, Hh, Hh, Hh, Mm, Mm, Mm
Rb, Rb, Rb, Rb, Gg, Gg, Gll^Fp, Gg, Hh, Hh, Hh, Hh, Hh, Gg, Gg, Gg, Gg, Gg, Gg, Gg, Gg, Gg, Hh, Hh, Hh, Hh, Hh, Mm, Mm
Rb, Rb, Gg, Gg, Gll^Fp, Gll^Fp, Hh, Hh, Mm, Mm, Mm, Mm, Mm, Mm, Hh^Vhh, Gg, Gg, Gg, Gg, Gg, Gg, Gg, Gg, Hh, Gll^Fp, Hh, Gll^Fp, Hh, Hh
Gg, Gg, Gg, Gll^Fp, Hh, Hh^Vhh, Mm, Mm, Mm, Mm, Mm, Mm, Mm, Mm, Mm, Hh, Hh, Gg, Gg, Gg, Gg, Gg, Gg, Gg, Gg, Gll^Fp, Gg^Efm, Gll^Fp, Gll^Fp
Gg^Efm, Gg^Efm, Gg^Efm, Gll^Fp, Hh, Mm, Mm, Mm, Mm, Mm, Mm, Mm, Mm, Mm, Mm, Hh, Gll^Fp, Gg, Gg, Gg, Gg, Gg, Gg, Gg, Gg, Gg, Gg^Efm, Gg^Efm, Gg^Efm
Gg^Efm, Gg^Efm, Gll^Fp, Hh, Mm, Mm, Mm, Mm, Mm, Mm, Mm, Mm, Mm, Mm, Mm, Hh^Vhh, Hh, Gll^Fp, Gll^Fp, Gg, Gg, Gg, Gg, Gg, Gg, Gg^Efm, Gg^Efm, Gg^Efm, Gg^Efm
Gg, Gg^Efm, Gll^Fp, Gll^Fp, Gll^Fp, Mm, Mm, Mm, Mm, Mm, Mm, Mm, Mm, Mm, Hh, Hh, Gll^Fp, Gll^Fp, Gll^Fp, Gg, Gg, Gg, Gg, Gg, Gg, Gg, Gll^Fp, Gll^Fp, Gll^Fp
Hh, Gg, Gg, Gll^Fp, Gll^Fp, Gll^Fp, Gg, Hh, Gg^Fet, Hh, Hh, Hh, Hh, Hh, Gll^Fp, Gll^Fp, Gll^Fp, Gll^Fp, Gg, Gg, Gg, Gg, Gg, Gg, Gll^Fp, Gll^Fp, Hh, Hh, Hh
Hh, Gg, Gg, Gg, Gg, Gg, Ce, Gg, Gg, Gg, Gg, Gll^Fp, Gll^Fp, Gll^Fp, Gll^Fp, Gll^Fp, Gg, Gg, Gg, Gg, Gg, Gg, Hh, Gll^Fp, Hh, Hh, Gll^Fp, Hh, Hh
Hh, Hh, Gg, Gg, Ce, Ce, Ce, Ce, Ce, Gg, Gg, Gg, Gg, Gll^Fp, Gg, Gg, Gg, Gg, Gg, Gg, Hh, Hh, Gll^Fp, Hh, Hh, Hh, Hh, Gll^Fp, Gll^Fp
Hh, Hh, Gg, Gg, Ce, Ce, 2 Ke, Ce, Ce, Gg, Gg, Gg, Gg, Gg, Gg, Gg, Gg, Gg, Gg, Gg, Hh, Hh, Hh, Gg^Fet, Gll^Fp, Hh, Mm, Mm, Mm
Mm, Hh, Hh, Gg, Ce, Ce, Ce, Ce, Ce, Gg, Gg, Gg, Gg, Gg, Gg, Gg, Gg, Gg, Gg, Gg, Hh, Hh, Hh, Gll^Fp, Mm, Mm, Mm, Mm, Mm
Mm, Mm, Gg^Fet, Hh, Hh, Ce, Ce, Ce, Gg, Gg, Gg, Gg, Gg, Gg, Gg, Gg, Gg, Gg, Hh, Hh, Gll^Fp, Gll^Fp, Mm, Mm, Mm, Mm, Mm^Xm, Mm^Xm, Mm^Xm
Mm, Mm, Mm, Hh, Hh, Hh, Hh, Gg, Gg, Gg, Gg, Gg, Ww, Ww^Ewf, Ww, Ww^Ewf, Ww^Ewf, Ww, Ww^Ewf, Gg^Fet, Gll^Fp, Gll^Fp, Mm, Mm, Mm^Xm, Mm^Xm, Mm^Xm, Mm^Xm, Mm^Xm
Mm, Mm, Mm, Mm, Mm, Hh, Hh, Gg, Gg, Gg, Gg, Ww^Ewf, Ww, Ww, Ww, Ww, Ww, Ww, Gg, Hh, Gll^Fp, Mm, Mm, Mm^Xm, Mm^Xm, Mm^Xm, Mm^Xm, Mm^Xm, Mm^Xm
